inj xqujch	in·jxqujch
inj xquich	in·jxquich
ini xquich	in·ixquich
I nic	Inic
I tzcoatzin	Itzcoatzin
tlato caiotl	tlatocaiotl
otlato catque	otlatocatque
tla¶ toani	tlatoani
tla¶ to catl	tlatocatl
y nipan¶	yn·ipan
quenin¶quipiaia	quenin·quipiaia
A uh	Auh
A uh¶	Auh
tenoch¶ titlan	tenochtitlan
tenochti¶ tlan	tenochtitlan
te¶ nochtitlan	tenochtitlan
xuch¶milca	xuchmilca
qujn¶peuh	qujnpeuh
Chimal popoca	Chimalpopoca
tlato cat	tlatocat
I njc	Injc
tla¶ toanj	tlatoanj
T icocicatzin	Ticocicatzin
chi come	chicome
tlato¶anj	tlatoanj
Me¶ xico	Mexico
coz¶ tic	coztic
xo¶ xouh qui	xoxouhqui
tilma¶ tli	tilmatli
chicoapal nacaz minqui	chicoapalnacazminqui
cue¶ tlastilmatli	cuetlastilmatli
ini quac	in·iquac
quin¶ icoac	quinicoac
qui cui	quicui
to¶ maiauh campa	tomaiauhcampa
A¶ uh	Auh
tlachiquacen caiotia	tlachiquacencaiotia
nacaz¶ tli	nacaztli
quin¶ peuh	quinpeuh
quj iauchiuh	qujiauchiuh
quauh naoac	quauhnaoac
moquauh naoa caitoa	moquauhnaoacaitoa
maca¶ oacan	macaoacan
Nece to chuiloc	Necetochuiloc
qui peuh¶	quipeuh
ini xquich¶	in·ixquich
A xaiaca	Axaiaca
moiao chiuhque	moiaochiuhque
io an	ioan
te¶ nochca	tenochca
po¶ liuh	poliuh
ao¶ cac	aocac
inj coac¶	in·jcoac
tlati¶ lulco	tlatilulco
mo quiuixtli	moquiuixtli
tlato¶ anj	tlatoanj
A ujtzotl	Aujtzotl
motla¶ po	motlapo
injn toca	in·jntoca
in tech¶ patlatoa	intechpa·tlatoa
xuch¶ milca	xuchmilca
qujn¶ peuh	qujnpeuh
on naui	onnaui
vmpo¶ alxiujtl	vmpoalxiujtl
chiquacen xiujtl	chiquacenxiujtl
caxtol xiujtl	caxtolxiujtl
nauh xiuitl	nauhxiuitl
matlac xihuitl	matlacxihuitl
ma tlacxiuitl	matlacxiuitl
exi¶ uitl	exiuitl
cempoalxi¶ ujtl	cempoalxiujtl
ie¶ hoatl	iehoatl
quj peuh	qujpeuh
tlacote¶ pec	tlacotepec
tzina cantepec	tzinacantepec
teo¶ xaoalco	teoxaoalco
o cujllan	ocujllan
te qualoia	tequaloia
coz caquauh¶ tenanco	cozcaquauhtenanco
xoch¶ caatl	xochcaatl
matlactlo mome	matlactlomome
A ca mapichtli	Acamapichtli
muchi uh	muchiuh
Quauh tlatoa	Quauhtlatoa
cax¶ tolli	caxtolli
cat¶ ca	catca
itz coatl	itzcoatl
muchi¶ uh	muchiuh
azca¶ putzalcatl	azcaputzalcatl
injxqujch	in·jxqujch
quauh naoacatl	quauhnaoacatl
M oqujujxtli	Moqujujxtli
cempo¶ alxiuitl	cempoalxiuitl
compeoal¶ ti	compeoalti
io coxca	iocoxca
mo¶ teneoa	moteneoa
inqujte¶ tzammatia	in·qujtetzammatia
inte¶ tzaujtl	in·tetzaujtl
inqujtetzammatia	in·qujtetzammatia
iniquac	in·iquac
inanoce	in·anoce
ilamachocaia	ilama·chocaia
intlejn¶	in·tlejn
mjtova¶ ia	mjtovaia
I nievecauh	In·ie·vecauh
inoc	in·oc
tlateo¶ toco	tlateotoco
injuh	in·juh
ce¶ qujntin	cequjntin
titixca¶ vitoque	titixcavitoque
to¶ tlalpan	totlalpan
tech¶ nelotoque	technelotoque
ve¶ ue tlaca	veuetlaca
inaia aque	in·aiaaque
inaiaque	in·aiaque
quj tetzamma¶ tia	qujtetzammatia
inquitetzaujttaia	in·quitetzaujttaia
innetetzaujloia	in·netetzaujloia
tlatetza¶ ujaia	tlatetzaujaia
iniquac	in·iquac
injuhquj	in·juhquj
te¶ quanj	tequanj
teh¶ cuiooa	tehcuiooa
ilama¶ pul	ilamapul
iniquac¶	in·iquac
iaomj¶ qujz	iaomjqujz
com monamjctiz	commonamjctiz
ic¶ noiotl	icnoiotl
motlanamjc¶ tiz	motlanamjctiz
quin mona¶ maqujliz	quinmonamaqujliz
qujn tlanamjctiz	qujntlanamjctiz
qujntlatlacul¶ namjctiz	qujntlatlaculnamjctiz
inj nextitlan	in·jnextitlan
Y njqc¶	Yn·jqc
quella¶ quaoa	quellaquaoa
intonalpouhquj	in·tonalpouhquj
injquac	in·jquac
Timotoli¶ nja	Timotolinja
injtlecujllan	in·jtlecujllan
injchan	in·jchan
tiquj tlanj	tiqujtlanj
mellaqua¶ oaloca	mellaquaoaloca
intimotezcaujco	in·timotezcaujco
intimamuxvico	in·timamuxvico
intlein	in·tlein
oticmo¶maceuj	oticmomaceuj
tla¶ caiectli	tlacaiectli
caiuh	ca·iuh
co¶ njtotiuj	conjtotiuj
tech cauh tiuj	techcauhtiuj
caujctli	ca·ujctli
ic noiotl	icnoiotl
quj temouja	qujtemouja
ieixqujch	ie·ixqujch
acotitlatlatzi ujti	aco·titlatlatziujti
mone¶ nequjz	monenequjz
maxicmotlatol¶ chieli	ma·xicmotlatolchieli
tonalama¶ pan	tonalamapan
cujtlapil¶ li	cujtlapilli
njmjtzihi¶ caviz	njmjtzihicaviz
inamotlacacemellecan	in·amo·tlacacemellecan
o¶ qujnec	oqujnec
mo¶ tlacaiocoia	motlacaiocoia
intequanj	in·tequanj
caiuh ca¶	ca·iuhca
tetza¶ vitl	tetzavitl
nj çan	njçan
qujtetzam matia	qujtetzammatia
inj quac	in·jquac
Quj toaia	Qujtoaia
Co¶ iutl	Coiutl
mj¶ toa	mjtoa
Inaqujn	In·aqujn
intetzaujtl	in·tetzaujtl
inqujchioaia	in·qujchioaia
mo¶ tetzaujanj	motetzaujanj
vn¶ can	vncan
ix¶ pampa	ixpampa
amo¶ qualli	amo·qualli
injtoca	in·jtoca
tezca¶ tlipuca	tezcatlipuca
tezcatli¶ puca	tezcatlipuca
tinech¶ macaz	tinechmacaz
intezcatlipuca	in·tezcatlipuca
intlamoquetza	intla·moquetza
quj cuj¶ tiuetziz	qujcujtiuetziz
canjc	can·jc
ie¶ oa	ieoa
incholoa	in·choloa
chololo¶ atiuh	chololoatiuh
amouel	amo·uel
con mauhcacaoa	conmauhcacaoa
quj toctia	qujtoctia
mo¶ mauhcatlaloa	momauhcatlaloa
tzonteco¶ matl	tzontecomatl
I nchiqujmoli	In·chiqujmoli
to totl	tototl
iuhqujn	iuhqujn
quauh chochopitli	quauhchochopitli
quj¶ tovaia	qujtovaia
inotioal¶ laque	in·otioallaque
iollo chicaoac	iollochicaoac
mauh¶ catlacatl	mauhcatlacatl
intlao quj mottiti	intla·oqujmottiti
quj¶ tonalcaoaltia	qujtonalcaoaltia
y¶ ciuhca	yciuhca
inaqujn	in·aqujn
qujmotti¶ tia	qujmottitia
mj iecpa¶	mjiecpa
icmocaquj	ic·mocaquj
ynjquac	yn·jquac
Inj quac¶	In·jquac
I quac¶	Iquac
I nj quac	In·jquac
inj quac¶	in·jquac
I nj¶ quac	In·jquac
inj¶ quac	in·jquac
intezca¶ tlipuca	in·tezcatlipuca
mi qui	miqui
iuh quj¶	iuhquj
intetzauhqujmjchin	in·tetzauhqujmjchin
quj¶ tonalcaoaltia	qujtonalcaoaltia
quj¶ oalmuchieltia	qujoalmuchieltia
quj¶ maceoaltia	qujmaceoaltia
injiollo	in·jiollo
intecocoliliztli	in·tecocoliliztli
quj¶ mottilia	qujmottilia
quj¶ neltocaia	qujneltocaia
quj¶ namjquj	qujnamjquj
quj¶ nextiaia	qujnextiaia
quj¶ machitia	qujmachitia
quj¶ nanqujlia	qujnanqujlia
quj¶ melaquaoa	qujmelaquaoa
quj¶ caquja	qujcaquja
quj¶ caquj	qujcaquj
quj¶ tovaia	qujtovaia
I njn	Injn
inj¶ toca	in·jtoca
ne¶ tetzaujloia	netetzaujloia
caqujz¶ tia	caqujztia
inouella llimjctimotecac	in·ouellallimjctimotecac
ina¶ ocac	in·aocac
I c	Ic
motetzauja¶ ia	motetzaujaia
chi¶ quatli	chiquatli
injtechpa	in·jtechpa
tza¶ tzitiqujca	tzatzitiqujca
tetza¶ ujttoia	tetzaujttoia
inchiquatli	in·chiquatli
ynjquac	yn·jquac
qujnel¶ tocaia	qujneltocaia
mj qujz	mjqujz
ieceme	ie·ceme
mj¶ qujzque	mjqujzque
cocoliz¶ cujzque	cocolizcujzque
inj¶ pan	in·jpan
aioc¶ mo	aiocmo
caticcaoazque	ca·ticcaoazque
ynoccequj	yn·occequj
tla¶ canex qujmjlli	tlacanexqujmjlli
tete¶ tzaujaia	tetetzaujaia
momj¶ mjlotiuh	momjmjlotiuh
tehten¶ tiuh	tehtentiuh
intlacan	intla·can
Tlenjc	Tlen·jc
tlanj qujt¶ ta	tla·njqujtta
qujtz timotlalia	qujtztimotlalia
cam¶ pa	campa
injqc¶	in·jqc
mo¶ teittitiaia	moteittitiaia
cujtla panton	cujtlapanton
inacolho¶ acan	in·acolhoacan
#
neaxixalo¶ ian	neaxixaloian
in¶ tlaie	intla·ie
incan icel¶	in·can·icel
inaco	in·aco
a¶ noco	anoco
iehmuch	ieh·much
mj¶ qujztetzaujtl	mjqujztetzaujtl
moca¶ caiaoa	mocacaiaoa
tla¶ quavac	tlaquavac
injmmac	in·jmmac
mocauhti¶ qujca	mocauhtiqujca
cacan	ca·can
iuh qujn	iuhqujn
injpalnemoanj	in·jpalnemoanj
machiotica	ma·chiotica
tonal ama¶ pan	tonalamapan
canel	ca·nel
oticmo¶ maceuj	oticmomaceuj
camopan	ca·mopan
motla¶ pal	motlapal
caoneltico	ca·oneltico
matitlaocux	ma·titlaocux
maximella¶ quaoa	ma·ximellaquaoa
inquenamj	in·quenamj
no yoan	no·yoan
Caizca	Ca·izca
Co¶ iotl	Coiotl
ienon	ie·non
ocnen	oc·nen
njmatzpaiaoa¶ lochtia	njmatzpaiaoalochtia
onie¶ cauh tiuetzi	oniecauhtiuetzi
inamatzintli	in·amatzintli
inmonextlao¶ al	in·monextlaoal
on muchioaz	onmuchioaz
jzquj¶ tlamantli	jzqujtlamantli
incopalli	in·copalli
njmjtzteteuh¶ tia	njmjtzteteuhtia
njcno¶ maujz	njcnomaujz
njc tlatlamantiliz	njctlatlamantiliz
injzqujcan	in·jzqujcan
canehoatl	ca·nehoatl
njc¶ nomaujtiuh	njcnomaujtiuh
tlachia¶ ia	tlachiaia
quj caquja	qujcaquja
intzatzia	in·tzatzia
v¶ tlica	vtlica
qujchio¶ aia	qujchioaia
injnpan	in·jnpan
inanoço	in·anoço
in¶ pan	inpan
inj qc¶	in·jqc
co¶ njtoa	conjtoa
inquenman¶	in·quenman
Inj qc¶	In·jqc
inj tla¶ tol	in·jtlatol
quj toa	qujtoa
netemma¶ cho	netemmacho
iuh quj nacovetzi¶	iuhqujn·acovetzi
ininiollo	in·iniollo
qujcnopilujz¶ que	qujcnopilujzque
iconiazque	ic·oniazque
mo¶ povatiuj	mopovatiuj
ieoquicacque	ie·oquicacque
injuh¶ quj	in·juhquj
tlatlapi¶ tzaoa	tlatlapitzaoa
inju hquj	in·juhquj
on quaquauhti	onquaquauhti
mocaca¶ naoa	mocacanaoa
on¶ tlanavi	ontlanavi
na¶ oati	naoati
tlaquechpili¶ uj	tlaquechpiliuj
con monamjctizque	conmonamjctizque
ievitz	ie·vitz
coco¶ liztli	cocoliztli
ieo almo¶ tzaquaz	ie·oalmotzaquaz
I njn pan	In·jnpan
quauh¶ ioocatla	quauhioocatla
intlapuchteca	intla·puchteca
nene¶ mjnj	nenemjnj
injn¶ pan	in·jnpan
A co	Aco
intlaqual¶ hoan	intlaqualhoan
ve¶ tziz	vetziz
iao¶ iotl	iaoiotl
ieconmonamjctizque	ie·conmonamjctizque
ieoalmotzaquaz	ie·oalmotzaquaz
tequa¶ tlaqualtin	tequatlaqualtin
ieontequancoalozque	ie·ontequancoalozque
on¶ vetzizque	onvetzizque
qujntlacen¶ cujlizque	qujntlacencujlizque
qujn tla cujcujlizque	qujntlacujcujlizque
in mac	inmac
tetlacuj¶ cujlique	tetlacujcujlique
om¶ maqujzque	ommaqujzque
tetlana¶ moelique	tetlanamoelique
ieontlatlacazque	ie·ontlatlacazque
qujn¶ tlanamoelizque	qujntlanamoelizque
ce¶ me	ceme
ieno	ie·no
quj queloa	qujqueloa
qujn¶ tlanamoelizque	qujntlanamoelizque
ce¶ me	ceme
tach¶ cauhchiuhtiuh	tachcauhchiuhtiuh
intachcauh	in·tachcauh
ica¶ tiuh	icatiuh
qujmixtla¶ machtia	qujmixtlamachtia
itlahoapaval¶ van	itlahoapavalvan
qujn choqujztla¶ paloa	qujnchoqujztlapaloa
Ximella¶ quauacan	Ximellaquauacan
noteic¶ caoane	noteiccaoane
toco¶ njttazque	toconjttazque
nopilhoa¶ ne	nopilhoane
inj¶ iollo	in·jiollo
inijollo	in·ijollo
ictioallaque	ic·tioallaque
intoiollo	in·toiollo
inpuchteca	in·puchteca
muchio¶ az	muchioaz
intimj¶ qujco	in·timjqujco
caiuh	ca·iuh
iuhqujoal¶ mattia	iuh·qujoalmattia
ticoalal¶ caujque	ticoalalcaujque
inton¶ ca	in·tonca
iniooaltica	in·iooaltica
inteca	in·teca
intauj	in·tauj
intotla	in·totla
in to¶ mach	in·tomach
caie	ca·ie
inichoqujz	in·ichoqujz
injtlaocul	in·jtlaocul
intotzon	in·totzon
nonoqujuh¶ toz	nonoqujuhtoz
intezco	in·tezco
macaiac	ma·caiac
macaiac¶	ma·caiac
quj¶ cioatlam achti	qujcioatlamachti
xicmotla¶ quammacacan	xicmotlaquammacacan
xicmo¶ tlatlauhtilican	xicmotlatlauhtilican
qujnjc	qujn·jc
iccem¶ maian	ic·cemmaian
ti¶ qujmjtauhcaiotico	tiqujmjtauhcaiotico
tiqujntonaleo¶ aco	tiqujntonaleoaco
in¶ totechiuhcaoan	intotechiuhcaoan
injia¶ que	in·jiaque
caieeppa	ca·ieeppa
intlacana	intla·cana
a¶ tlauhcamac	atlauhcamac
onmoce¶ mololoa	onmocemololoa
mo¶ nechicoa	monechicoa
qujcen¶ cujtlalpia	qujcencujtlalpia
qujcem¶ mana	qujcemmana
injntopil	in·jntopil
injpanqujxeoaia¶	in·jpan·qujxeoaia
ininteouh	in·inteouh
ix¶ pan	ixpan
monacazte¶ quj	monacaztequj
qujmocem¶ macatoque	qujmocemmacatoque
om¶ muchioaz	ommuchioaz
ontlama¶ ti	ontlamati
o¶ qujn tetzauj	oqujntetzauj
quj mottitia	qujmottitia
acacotle	acaco·tle
injnmaujzcujian	in·jnmaujzcujian
nemauhti¶ aia	nemauhtiaia
omuchiuh¶ ca	omuchiuhca
Intlacatle	Intla·catle
occeppa	oc·ceppa
oalmoioliz¶ calia	oalmoiolizcalia
onmoquaaha¶ iouja	onmoquaahaiouja
inamo¶	in·amo
inamotonalla¶ paliuj	in·amo·tonallapaliuj
inquj¶ mamattiuj	in·qujmamattiuj
tlacujcujloti¶ uj	tlacujcujlotiuj
a¶ iocmo	aiocmo
inoc nen¶	in·oc·nen
inquj¶ mati	in·qujmati
qujncana	qujn·cana
commo¶ namjctizque	commonamjctizque
intlein	in·tlein
quj tozne¶ quj	qujtoznequj
injco¶ motetzaujque	injc·omotetzaujque
inaca¶ nocomo	in·acanocomo
motene¶ oa	moteneoa
intetzam¶ machoia	in·tetzammachoia
tlatepuzmj¶ uja	tlatepuzmjuja
moca¶ quj	mocaquj
I nontlamaceoato	In·ontlamaceoato
inonacxoiatlalito	in·onacxoiatlalito
injntlamaceoaian	in·jntlamaceoaian
inca¶ co	in·caco
moca¶ quja	mocaquja
quauh xeloa	quauhxeloa
temamauh¶ ti	temamauhti
teiol mjcti	teiolmjcti
io altepuztli	ioaltepuztli
In in	Inin
Inaqujn¶	In·aqujn
injiollo¶	in·jiollo
inamo	in·amo
momauh tianj	momauhtianj
i¶ njc	injc
motla¶ paltilia	motlapaltilia
quj teputz¶ toca	qujteputztoca
inquenamj	in·quenamj
ite¶ tzauh	itetzauh
injuh	in·juh
momauh tianj	momauhtianj
inoqujciammjcti	in·oqujciammjcti
quj¶ oalmuchieltia	qujoalmuchieltia
iuh qujntlacatl	iuhqujn·tlacatl
quechte¶ pultic	quechtepultic
iuh quj nommonamjquj	iuhqujn·ommonamjquj
oncha¶ chaquanj	onchachaquanj
on moca¶ ca mapiquj	onmocacamapiquj
quech¶ cotonquj	quechcotonquj
ieiehoatl	ie·iehoatl
y¶ naqujn	yn·aqujn
tlama¶ cazquj	tlamacazquj
injaotlaueliloc	in·jaotlaueliloc
inouelca¶ cic	in·ouel·cacic
quj¶ mottilia	qujmottilia
quj¶ tlalochana	qujtlalochana
icqujtlaitlanjlia	ic·qujtlaitlanjlia
intlein quj nemac¶ tiz	in·tlein·qujnemactiz
ne¶ cujltonolli	necujltonolli
o¶ quhchiotl	oquhchiotl
camuchie	ca·much·ie
quj maceoaltiz	qujmaceoaltiz
inouel	in·ouel
in¶ tlaiequjnotza	intla·ie·qujnotza
xinech caoa	xinechcaoa
njmjtz¶ mazca	njmjtzmazca
intlein	in·tlein
ictenotzaia	ic·tenotzaia
inaqujn	in·aqujn
inj piltoca	in·jpiltoca
tletinechiluja	tle·tinechiluja
ino¶ qujmottiti	in·oqujmottiti
amonjmjtzcaoaz	amo·njmjtzcaoaz
caonj¶ mjtzan	ca·onjmjtzan
injol¶ lochicaoac	in·jollochicaoac
ienauj	ie·nauj
in¶ tlaeei	intla·eei
vitz¶ tli	vitztli
iniavc	in·iavc
inoqujtenevilli	in·oqujtenevilli
inoquj¶ macac	in·oqujmacac
quj¶ maceoaltia	qujmaceoaltia
intlalticpan	in·tlalticpan
paqujliz¶ tli	paqujliztli
inj¶ ietl	in·jietl
intilmatli	in·tilmatli
intencacatl	in·tencacatl
intlalpilonj	in·tlalpilonj
innenonotzalli	in·nenonotzalli
inaqujn	in·aqujn
qujtlatla¶ toltia	qujtlatlatoltia
qujcotonj¶ lia	qujcotonjlia
quj tlatzcotonjlia	qujtlatzcotonjlia
in ijollo	in·ijollo
inoqujco¶ tonjli	in·oqujcotonjli
inotlathujc	in·otlathujc
in tlaqualli	intla·qualli
mo¶ lontica	molontica
ano¶ co	anoco
icqujnextia	ic·qujnextia
inj¶ maceoal	in·jmaceoal
in¶ tlacamo	intlacamo
o¶ qujmaceoalti	oqujmaceoalti
ina¶ mo	in·amo
mauhca¶ tlacatl	mauhcatlacatl
quj¶ caquj	qujcaquj
ontlacuecue¶ tlaxoa	ontlacuecuetlaxoa
onciam mjquj	onciammjquj
on¶ moci auhcanequj	onmociauhcanequj
injna¶ caio	in·jnacaio
a¶ iocmo	aiocmo
ommaujl¶ ti	ommaujlti
ino¶ qujmacac	in·oqujmacac
qujca¶ quj	qujcaquj
tlaaca	tla·aca
y¶ tlapantenco	ytlapantenco
tla¶ tetzaujaia	tlatetzaujaia
te¶ culutl	teculutl
tecoloo¶ o	tecolooo
y vin	yvin
incaqujzti	in·caqujzti
iquauh ticpac	iquauhticpac
inchoca	in·choca
Quj¶ toa	Qujtoa
mjqujzte¶ tzaujtl	mjqujztetzaujtl
iemjqujz	ie·mjqujz
tla¶ tlatziujti	tlatlatziujti
iao¶ mjqujz	iaomjqujz
iecho¶ loz	ie·choloz
ietlalpoliujz	ie·tlalpoliujz
aca¶ oatimanjz	acaoatimanjz
jtho¶ alli	jthoalli
tlauj¶ ujtontoz	tlaujujtontoz
nema¶ naujloz	nemanaujloz
on¶ moteiotico	onmoteiotico
otla¶ maviz mamanca	otlamavizmamanca
otlatetz caliuh¶ timanca	otlatetzcaliuhtimanca
macel	ma·cel
inj caltech	in·jcaltech
y¶ naxcan	yn·axcan
iecaiuhcan	ie·ca·iuhcan
catepan¶ tli	ca·tepantli
iemjquiz	ie·mjquiz
Au h	Auh
intlaieoppa	intla·ie·oppa
ieexpa¶	ie·expa
ievncan	ie·vncan
intla¶ panjxquac	in·tlapanjxquac
incalipan	in·calipan
chiqua¶ tli	chiquatli
ommatin¶	ommat·in
icqujtocaiotiaia	ic·qujtocaiotiaia
chi¶ quatli	chiquatli
maxitlamattiuh¶	ma·xitlamattiuh
tic¶ ieco	ticieco
incihoa	in·cihoa
maxitlamatpolotiuh	ma·xitlamatpolotiuh
cujlon¶ pul	cujlonpul
icnatli¶ tiaz	ic·natlitiaz
caiamo	ca·iamo
innjiaz	in·njiaz
icone¶ patilo	ic·onepatilo
qujlmachiuhqujn	qujlmach·iuhqujn
icqueleltia	ic·queleltia
inj tenotzaliz	in·jtenotzaliz
icqujn tzatzilia	ic·qujntzatzilia
motetzauj¶ aia	motetzaujaia
Icchiquacen	Ic·chiquacen
coca¶ matl	cocamatl
con monamjctiz	conmonamjctiz
incampa¶	in·campa
quj mjctizque	qujmjctizque
ietlatolli	ie·tlatolli
itecho¶ neoaz	itech·oneoaz
contlatolchichiuj¶ liz	contlatolchichiujliz
netlacmauh¶ tilo	netlacmauhtilo
cuecue¶ ioca	cuecueioca
ticuecue¶ ioca	ticuecueioca
intenacaio	in·tenacaio
yxtecuj¶ cujpul	yxtecujcujpul
injctlatoa	injc·tlatoa
tocujle¶ choa	tocujlechoa
noiaotequjoa	no·iaotequjoa
qujto caiotiaia	qujtocaiotiaia
inj techpa¶	in·jtechpa
jevnca laquj¶	je·vncalaquj
intochin	in·tochin
ietlalpoli¶ ujz	ie·tlalpoliujz
A noco	Anoco
intochtli	in·tochtli
iemo¶ macatiliz	ie·momacatiliz
ten tipontic	tentipontic
tentete¶ pontic	tentetepontic
cujtlapiltete¶ pontic	cujtlapiltetepontic
pinaujz¶ tli	pinaujztli
tla¶ tlactic	tlatlactic
icam pa	icampa
inqujtoca	in·qujtoca
conciauhca¶ oa	conciauhcaoa
invalmonextia	in·valmonextia
intlaiequjtoca	in·tlaiequjtoca
quj mot titia	qujmottitia
pepe iocatiuh	pepeiocatiuh
nene mj	nenemj
inj tzon	in·jtzon
inj tzonquen	in·jtzonquen
icqujte¶ tzanuja	ic·qujtetzanuja
quj monamjctiz	qujmonamjctiz
quj iacanamj¶ quj	qujiacanamjquj
ievitz	ie·vitz
tlaoittoc	tla·oittoc
inaqujn¶	in·aqujn
nauhcam¶ pa	nauhcampa
quj tlalxochilia	qujtlalxochilia
ne¶ pantla	nepantla
on¶ chicha	onchicha
ino quj mottiti	in·oqujmottiti
vm¶ pa	vmpa
quj toznequj	qujtoznequj
cen¶ ca	cenca
motetza¶ uj	motetzauj
toconmatti¶ ezque	toconmattiezque
macaqujnjcticmatizque	ma·ca·qujn·jc·ticmatizque
contla¶ lia	contlalia
vc¶ tli	vctli
nomjtoa	no·mjtoa
noqualli	no·qualli
te¶ macehoal	temacehoal
inj toca	in·jtoca
iemj qujz	ie·mjqujz
intechan	in·techan
camjlpan	ca·mjlpan
nono¶ palla	nonopalla
inj nemjia	in·jnemjia
injqujcaia	in·jqujcaia
canazne¶ quj	canaznequj
inace	in·ace
caco quetza	cacoquetza
qujnj¶ quac	qujnjquac
intlaieuel	intla·ie·uel
itechonaci	itech·onaci
injiel	in·jiel
injcujtlapil	in·jcujtlapil
a¶ iauhcocamalotl	aiauhcocamalotl
icmo quetza	icmoquetza
inijel	in·ijel
aiax¶ can	aiaxcan
ictla¶ calo	ic·tlacalo
mo¶ teca	moteca
teiacaxo¶ locho	teiacaxolocho
intetilma	in·tetilma
icmo quetza	ic·moquetza
mj¶ necuj	mjnecuj
ineco	in·eco
in¶ tla	intla
como¶ njz	comonjz
intepilchoa	in·tepilchoa
ine¶ co	ineco
inqujqujmjchtin	in·qujqujmjchtin
injntechpa	in·jntechpa
quj toaia¶	qujtoaia
totecoco¶ licauh	totecocolicauh
quj teto¶ qujlia	qujtetoqujlia
te cocolianj	tecocolianj
mo¶ cuepa	mocuepa
oquj tocaque	oqujtocaque
te¶ mjqujtlanjnj	temjqujtlanjnj
inte mj qujztemachi¶ que	in·temjqujztemachique
in temj qujz temachianj	in·temjqujztemachianj
inatlaca	in·atlaca
intlatlaca¶ teculo	in·tlatlacateculo
inaz came	in·azcame
inazcame	in·azcame
intlatlauhque	in·tlatlauhque
icqujtetza¶ uja	ic·qujtetzauja
mone¶ quj	monequj
injmjqujz	in·jmjqujz
ina¶ qujn	in·aqujn
con nectia	connectia
connequj¶ lia	connequjlia
tlaqua¶ lanja	tlaqualanja
tlaa¶ mana	tlaamana
y nacanoço	yn·acanoço
inqujualtoca	in·qujualtoca
com mauh cacaoa	commauhcacaoa
icam¶ pa	icampa
quj mot¶ titia	qujmottitia
om¶ polivi	ompolivi
Caienoiuhquj	Ca·ie·no·iuhquj
muchiuh¶ quj	muchiuhquj
amomma¶ ca	amommaca
caonjmjtzan	ca·onjmjtzan
nj¶ mjtzcaoaz	njmjtzcaoaz
quj tlatoltia	qujtlatoltia
con mamauhtia	conmamauhtia
y¶ nacanoço	yn·acanoço
co¶ talotica	cotalotica
iuh quj¶	iuhquj
tetlaque¶ chililli	tetlaquechililli
quj mj ttaia¶	qujmjttaia
motetza¶ ujaia	motetzaujaia
quj nameti	qujnameti
inecue¶ paliz	in·ecuepaliz
intlacateculotl	in·tlacateculotl
muchic	much·ic
a¶ co	aco
iaomj qujz	iaomjqujz
tlaca¶ ujiac	tlacaujiac
inecue¶ paliz	inecuepaliz
i¶ naqujn	in·aqujn
injollotla¶ paliuj	in·jollotlapaliuj
intonalchicavac	in·tonalchicavac
quj¶ caoa	qujcaoa
qujteteuh tzitzquja	qujteteuhtzitzquja
mopi¶ loa	mopiloa
qujte¶ molia	qujtemolia
intlamaliztli	in·tlamaliztli
ahqujmamat¶ caoa	ahqujmamatcaoa
con¶ tepachoa	contepachoa
qujcne¶ lia	qujcnelia
neto¶ linjliztli	netolinjliztli
mecapal¶ li	mecapalli
mauh catlacatl	mauhcatlacatl
nj¶ man	njman
inj temamauh¶ tiliz	in·jtemamauhtiliz
aoc¶ mo	aocmo
inj¶ camac	in·jcamac
qujoalittazne¶ quj	qujoalittaznequj
momauh catlaloa	momauhcatlaloa
injuh	in·juh
moma¶ ti	momati
ino¶ quenteltzin	in·oquenteltzin
motlaloti¶ calaquj	motlaloticalaquj
injtla¶ tzacujl	in·jtlatzacujl
mo¶ caquj	mocaquj
mote¶ neoa	moteneoa
naoal¶ tetemoz	naoaltetemoz
qujtotoca¶ tinemj	qujtotocatinemj
injzquj	in·jzquj
iooalne¶ nemj	iooalnenemj
ite¶ nemac	itenemac
in¶ tlaieo qujmottiti	intla·ie·oqujmottiti
qujteteuhtzitz¶ quja	qujteteuhtzitzquja
actehoatl	ac·tehoatl
qujte¶ temoa	qujtetemoa
qujca¶ oa	qujcaoa
ina¶ tlaca	in·atlaca
pipitzca¶ ticate	pipitzcaticate
qujnte toqujliaia	qujntetoqujliaia
inte cocolianj	in·tecocolianj
inj cotzco	in·jcotzco
cha¶ chapaton	chachapaton
tzon queme	tzonqueme
tzotzoquen¶ pile	tzotzoquenpile
inj¶ tzon	in·jtzon
inj tzonquen	in·jtzonquen
nene¶ mj	nenemj
pepe¶ iocatiuh	pepeiocatiuh
quj mot¶ titia	qujmottitia
intlaiequjtoca	intla·ie·qujtoca
om¶ polivi	ompolivi
canjc quj queloa	can·jc·qujqueloa
invalmonextia	in·valmonextia
com mauh cacaoa	commauhcacaoa
conciauhca¶ oa	conciauhcaoa
intlaiecaamana	intla·ie·caamana
inace¶	in·ace
qujtlat¶ hujltia	qujtlathujltia
mo¶ iollo	moiollo
tinech¶ macaz	tinechmacaz
inoquj¶ iolpachiujti	in·oqujiolpachiujti
inoqujiolpachiuhcaioti¶	in·oqujiolpachiuhcaioti
tlaltic¶ pac	tlalticpac
oelciciuhti¶ nenca	oelciciuhtinenca
te teuh	teteuh
ynjx¶ qujch	yn·jxqujch
ynjnoan¶	yn·jnoan
y techpa	ytechpa
J nic	Jnic
ve cauh	vecauh
ma¶ ceoalli	maceoalli
iao¶ tlatoanj	iaotlatoanj
caitechpa	ca·itechpa
ma malhoaz¶ tli	mamalhoaztli
tla chinolli	tlachinolli
mal¶ mjcoaia	malmjcoaia
muchichioa¶ ia	muchichioaia
xiuhcoa¶ naoale	xiuhcoanaoale
tzi¶ tzile	tzitzile
tla¶ toa	tlatoa
qujtlama¶ njliaia	qujtlamanjliaia
mote patillotianj	motepatillotianj
moteixiptlatianj	moteixiptlatianj
vitzilubuch¶ tli	vitzilubuchtli
yniquac	yn·iquac
motocaio¶ tia	motocaiotia
qujto¶ totzaia	qujtototzaia
qujntlama¶ njliaia	qujntlamanjliaia
qujtlalochtoca¶ ia	qujtlalochtocaia
te¶ uhtli	teuhtli
qujpototz¶ tiuja	qujpototztiuja
tlaixquj qujca	tlaixqujqujca
qujnapa¶ lotiuja	qujnapalotiuja
quetzalapaneca¶ iutl	quetzalapanecaiutl
xi¶ uhia ca mjoa	xiuhiacamjoa
eltezca¶ oa	eltezcaoa
qujtla¶ manjliia	qujtlamanjliia
teupouh quj	teupouhquj
mo¶ tecaia	motecaia
y nj ne¶ chichioal	yn·jnechichioal
azta tzone	aztatzone
amanaco¶ che	amanacoche
chaia¶ oac	chaiaoac
vme¶ tuch chimale	vmetuchchimale
tla chinolli	tlachinolli
malhoaz¶ tli	malhoaztli
atla¶ ca cemelle	atlacacemelle
mal¶ mjcoaia	malmjcoaia
muchichioa¶ ia	muchichioaia
mote patillotianj	motepatillotianj
moteixip¶ tlatianj	moteixiptlatianj
y njtoca	yn·jtoca
ia¶ utl	iautl
qujtemouj¶ aja	qujtemoujaja
qujteecaujltiaia	qujteecaujltiaia
qujtecujtia¶ ia	qujtecujtiaia
y njx quich	yn·jxquich
mu¶ chioaia	muchioaia
te que que¶ loaia	tequequeloaia
qujte ecaujltiaia	qujteecaujltiaia
qujtema¶ caia	qujtemacaia
te¶ cuiotl	tecuiotl
tla¶ toaia	tlatoaia
ynteutl	yn·teutl
quj¶ locoaia	qujlocoaia
i¶ tech	itech
quj pixo¶ aia	qujpixoaia
qui cue ponal¶ tiaja	quicueponaltiaja
tla¶ macazquj	tlamacazquj
teila qujliztli	teilaqujliztli
mu¶ chichioaia	muchichioaia
tla¶ ixolhujlli	tlaixolhujlli
ix mjchioa¶ ve	ixmjchioave
chalchi¶ uhcozque	chalchiuhcozque
po culcaque	poculcaque
que¶ tzalcoatl	quetzalcoatl
y tech¶ pa	ytechpa
ynteia¶ cancauh	ynteiacancauh
yn tlachpancauh	yntlachpancauh
tlalo¶ que	tlaloque
qujqujiauh¶ ti	qujqujiauhti
tla¶ tlalpitza	tlatlalpitza
motlatla¶ ueltia	motlatlaueltia
ehe¶ ca	eheca
y nj quac	yn·jquac
y coioca	ycoioca
he¶ canechioale	hecanechioale
y noc	yn·oc
teucujtla¶ a cuechcozque	teucujtlaacuechcozque
quetzalcoxollama¶ male	quetzalcoxollamamale
ic pa omjcicuj¶ le	icpaomjcicujle
qujnmoteuti¶ aia	qujnmoteutiaia
tetza¶ ujtl	tetzaujtl
ic noiutl	icnoiutl
quj¶ teittitia	qujteittitia
me¶ capalli	mecapalli
temo¶ tlaia	temotlaia
moteittitia¶ ia	moteittitiaia
tec¶ pan	tecpan
iitznaco¶ che	iitznacoche
iztazti¶ cac	iztazticac
y njne¶ axtlaoal	yn·jneaxtlaoal
ynj¶ xaiac	yn·jxaiac
centlaco chichiltic	centlacochichiltic
cen¶ tlacotliltic	centlacotliltic
teu¶ cujtla nacoche	teucujtlanacoche
quech queme	quechqueme
mj¶ xcoaia	mjxcoaia
to¶ nacaiotl	tonacaiotl
y¶ nenca	ynenca
y iolca	yiolca
y njoa	ynjoa
yn qualo	ynqualo
yn ne¶ chichioale	ynnechichioale
ixtlauh xaoa¶ le	ixtlauhxaoale
a¶ xochiacueie	axochiacueie
tonatiuh chimale	tonatiuhchimale
Tlal¶ li	Tlalli
y iollo	yiollo
qujmoteu¶ tiaja	qujmoteutiaja
a¶ tlan	atlan
tetlacujcuj¶ lique	tetlacujcujlique
te¶ ixocujlanque	teixocujlanque
temazca¶ leque	temazcaleque
y pampa	ypampa
y njxiptla	yn·jxiptla
ilhujqujxti¶ liloia	ilhujqujxtililoia
qujtlaoculpopoloa¶ ia	qujtlaoculpopoloaia
que elelqujx¶ tiaia	queelelqujxtiaia
qujtla¶ ne nequjltiaia	qujtlanenequjltiaia
ha¶ qujchoctlanja	haqujchoctlanja
qujne¶ caliltiaia	qujnecaliltiaia
qujtla¶ caoachiliaia	qujtlacaoachiliaia
tlauiz¶ nextiloia	tlauiznextiloia
netla¶ uhtiloia	netlauhtiloia
muchi¶ oaia	muchioaia
qujn ticauja¶ ia	qujnticaujaia
qujn potonjaia	qujnpotonjaia
quj motza¶ cujlitiuja	qujmotzacujlitiuja
on ma qujaia	onmaqujaia
ynj¶ eoaio	yn·jeoaio
yn nepantla	ynnepantla
oalmoquetxa¶ ia	oalmoquetxaia
qujujca¶ ia	qujujcaia
moticau¶ ique	moticauique
motlotlo ujtecque	motlotloujtecque
pe¶ petlauhtiuj	pepetlauhtiuj
mahma¶ laca quetzallo	mahmalacaquetzallo
hiuj¶ quetzallo	hiujquetzallo
toci¶ titlan	tocititlan
quauh tlapechco	quauhtlapechco
contlali¶ aia	contlaliaia
y njeoaio	yn·jeoaio
ne¶ chichioale	nechichioale
tlaxapu¶ chtli	tlaxapuchtli
y njca mapa¶	yn·jcamapa
cuech¶ cueie	cuechcueie
mo cuech cueti	mocuechcueti
quavi¶ vih	quavivih
y njuipil	yn·juipil
qua¶ uhtzetze liuh quj	quauhtzetzeliuhquj
y nj chimal	yn·jchimal
teu¶ cujtla y tixapo	teucujtlaytixapo
y njtoca¶	yn·jtoca
y nacaio	ynacaio
y nexitl¶	yn·exitl
qui palcuja¶	quipalcuja
y ntenacaio	yn·tenacaio
y naqujn	yn·aqujn
quaxococi¶ uj	quaxocociuj
tozcamjiaoa ciuj	tozcamjiaoaciuj
motozcaoxi¶ uja	motozcaoxiuja
xo¶ tzaianj	xotzaianj
ic xitzatzaianj	icxitzatzaianj
intlaxcaliciuj	in·tlaxcaliciuj
y nj chiaoaca	yn·jchiaoaca
y nj¶ tonal	yn·jtonal
y¶ njquac	yn·jquac
y noxinama¶ caque	yn·oxinamacaque
tlacamjctia¶ ia	tlacamjctiaia
y nj xiptla	yn·jxiptla
quj¶ cujcatiaia	qujcujcatiaia
y ni ve ve iooan	yn·iveveiooan
quj te po¶ nacilhujaia	qujteponacilhujaia
caiouj¶ tequjlia	caioujtequjlia
comjchica¶ oacilhuja	comjchicaoacilhuja
ome¶ xaoale	omexaoale
ynj amacal	yn·jamacal
que¶ tzalmjiaoaio	quetzalmjiaoaio
aiu chicaoace	aiuchicaoace
ynte¶ chpa	yntechpa
cioapi¶ pilti	cioapipilti
y nj ne¶ chichioal	yn·jnechichioal
azta¶ tzone	aztatzone
itzto pile	itztopile
tecpa¶ topile	tecpatopile
notzitzile	no·tzitzile
y nj mixiptlaoan	yn·jmixiptlaoan
mocaia¶ oa	mocaiaoa
y njc	ynjc
tla¶ uelilocati	tlauelilocati
ixnecuj¶ liuj	ixnecujliuj
ic¶ ximjmjquj	icximjmjquj
ten¶ qualacquica	tenqualacquica
omotena¶ micti	omotenamicti
y pan	ypan
cioapipil¶ ti	cioapipilti
cioa¶ pipilti	cioapipilti
qujmil¶ hujaia	qujmilhujaia
y njn pilhoan	yn·jnpilhoan
xon¶ qujca	xonqujca
y niquac¶	yn·iquac
qujntlamanj¶ liaia	qujntlamanjliaia
papalo tlax¶ calli	papalotlaxcalli
xo cuichtlama¶ tzoalli	xocuichtlamatzoalli
ynjn nechichi¶ oal	yn·jnnechichioal
pa¶ nj	panj
tlaitzcopcoaltec¶ tli	tlaitzcopcoaltectli
y nj mama¶ tlaquen	yn·jmamatlaquen
potonca ca que que	potoncacaqueque
y cue	ycue
cioa teutl	cioateutl
ynj¶ toca	yn·jtoca
mjtoa¶ ia	mjtoaia
yn van	ynvan
in uel¶ tiuh	inueltiuh
y nic	ynic
mauizti¶ liloia	mauiztililoia
y njc¶	ynjc
tlamauhtia¶ ia	tlamauhtiaia
teatlan mjctiaia	teatlanmjctiaia
mo te¶ ponacoa	moteponacoa
mo¶ teujlacachoa	moteujlacachoa
tecentla njujca	tecentlanjujca
quj cuepa	qujcuepa
qujx tlapach¶ cuepa	qujxtlapachcuepa
ma¶ ia uj	maiauj
catema	ca·tema
te apotzauja	teapotzauja
mocue¶ iotia	mocueiotia
y¶ nj quac	yn·jquac
ia¶ iauh	iaiauh
xixiquj¶ piliuj	xixiqujpiliuj
on mo chachaqua¶ nja	onmochachaquanja
mapopoco quillotia	mapopocoquillotia
tlamattima¶ nj	tlamattimanj
petlantima¶ nj	petlantimanj
cue cue iocatimanj	cuecueiocatimanj
ynj¶ quac	yn·jquac
noiquac¶	no·iquac
y netzalqualiztli	yn·etzalqualiztli
y n	yn
ilhuj¶ qujxtililoia	ilhujqujxtililoia
quj chichioaia	qujchichioaia
y xiptla	yxiptla
quj cue¶ tiaia	qujcuetiaia
quj cozcati¶ aia	qujcozcatiaia
qujtla manjliaia	qujtlamanjliaia
quj na na miquj¶	qujnanamiquj
y nj tle na ma ca cauh	yn·jtlenamacacauh
y iauhtli	yiauhtli
quj te pe vilia	qujtepevilia
caio chi caoaz¶	caiochicaoaz
calpo¶ leque	calpoleque
y cujca caoan	ycujcacaoan
ie hoan	iehoan
y quac	yquac
quj nex¶ tiaia	qujnextiaia
a¶ tlacuj	atlacuj
apan¶ tlaca	apantlaca
tian¶ quizco	tianquizco
Noiuh¶	No·iuh
qujtlama¶ macaia	qujtlamamacaia
quj cenca oaia	qujcencaoaia
y tocaio çan¶	ytocaioçan
tlenamaco¶ ia	tlenamacoia
y nj xiptla	yn·jxiptla
quj iauh tla tlanj	qujiauhtlatlanj
tla¶ catl	tlacatl
qujtlamace huja	qujtlamacehuja
y nj ma¶ ceoal	yn·jmaceoal
mocnelilma¶ ti	mocnelilmati
y njc	ynjc
quj mahujz tiliaia	qujmahujztiliaia
qujl na mjquja	qujlnamjquja
caic	ca·ic
y n¶	yn
quj mauiz tiliaia	qujmauiztiliaia
y nj toca	yn·jtoca
y nj e	yn·je
tla manjx¶ ti	tlamanjxti
y nenca	ynenca
mace¶ oalli	maceoalli
y toca	ytoca
y ujn	yujn
moxaoa¶ ia	moxaoaia
motexo¶ tenujltec	motexotenujltec
mjxco calhuj	mjxcocalhuj
chal chiuh¶ cuzque	chalchiuhcuzque
xiuh na co che	xiuhnacoche
texo ama¶ cale	texoamacale
quetzal mj ia oaio	quetzalmjiaoaio
atlacujlol¶ hvipile	atlacujlolhvipile
atla cujlolhuiuj pile	atlacujlolhuiujpile
atla cuj lol¶ cueie	atlacujlolcueie
atla cue conan chimale	atlacueconanchimale
aiu¶ chicaoace	aiuchicaoace
capi¶ tulo	capitulo
tlacol¶ teutl	tlacolteutl
tlacul teutl	tlaculteutl
moto¶ caiotia	motocaiotia
y iaxca	yiaxca
y tlat quj	ytlatquj
y tech	ytech
avil ne mjliztli	avilnemjliztli
a¶ ujlnemjlizcutl	aujlnemjlizcutl
ci¶ oa	cioa
te¶ teu	teteu
tlacul te teu	tlaculteteu
y n jx quj¶ ch	yn·jxqujch
ne qualli	nequalli
mome¶ laoa	momelaoa
y nj xqujch	yn·jxqujch
tla hella chioalli	tlahellachioalli
te mamauhti	temamauhti
im¶ manel	immanel
mopina¶ vizcaoa	mopinavizcaoa
te motla	temotla
tlacul¶ teutl	tlaculteutl
quj¶ tepolhuja	qujtepolhuja
tlana¶ oac	tlanaoac
te papaca	tepapaca
te haltia	tehaltia
y m matlalatl	ym·matlalatl
intoxpalatl	in·toxpalatl
neiol cujtilo	neiolcujtilo
i ixpan	iixpan
neiol¶ melaoalo	neiolmelaoalo
y ntlaculteutl	yn·tlaculteutl
te tlachioal	tetlachioal
i ixpa¶	iixpa
y nacaz	ynacaz
y tla cac cauh¶	ytlacaccauh
tla pouhquj	tlapouhquj
tla¶ pouhquj	tlapouhquj
tla¶ matinj	tlamatinj
y nj mac	yn·jmac
y n a¶ muxtli	yn·amuxtli
tla cujlolli	tlacujlolli
quj pia¶	qujpia
oquj¶ to	oqujto
tlapilchioa¶ le	tlapilchioale
qujtla ca qujtia	qujtlacaqujtia
Cay tech¶ tzinco	Ca·ytechtzinco
nj na xitiznequj	njnaxitiznequj
y ioalli	yioalli
y petla¶ caltzin	ypetlacaltzin
y topzin	ytopzin
njc nottitiliznequj	njcnottitiliznequj
Qujl¶ huja	Qujlhuja
otimo tlac¶ nelili	otimotlacnelili
y ni qujn¶	yn·iqujn
quj¶ tta	qujtta
y nj amux	yn·jamux
y njtlacujlol	yn·jtlacujlol
y niqujn	yn·iqujn
y¶ quac	yquac
y naoatilpan	ynaoatilpan
pe¶ tlatl	petlatl
tla¶ maceuhquj	tlamaceuhquj
mo¶ iolmelaoa	moiolmelaoa
te¶ ujc	teujc
ian¶ cuje	iancuje
vellach¶ pano	vellachpano
nj man	njman
con¶ tema	contema
ve¶ ue	veue
cuj¶ tlapilli	cujtlapilli
maceoa¶ lli	maceoalli
atla palli	atlapalli
tlaocuxti¶ ujtz	tlaocuxtiujtz
Tla¶ catle	Tlacatle
naoa¶ quehe	naoaquehe
y nj nentlamachi¶ liz	yn·jnentlamachiliz
quj¶ notza	qujnotza
y ujctzinco	yujctzinco
iix¶ pantzinco	iixpantzinco
tic molhujlico	ticmolhujlico
ticmo¶ tlapolhujlico	ticmotlapolhujlico
im mope¶ tlacal	immopetlacal
xi¶ momamaxauj	ximomamaxauj
naoa¶ que	naoaque
ehe¶ catl	ehecatl
to¶ tecujo	totecujo
y njn¶	ynjn
maxictlapo	ma·xictlapo
mo¶ top	motop
y vin¶	yvin
que njn	quenjn
xie¶ petlanj	xiepetlanj
maqual¶ tica	maqualtica
mo¶ macoaltitica	momacoaltitica
mati¶ mopinoquetz	ma·timopinoquetz
intlamaceuhquj	in·tlamaceuhquj
oncopal¶ tema	oncopaltema
tevi¶ ujti	teviujti
teixip¶ tla	teixiptla
caticmoca¶ qujtia	caticmocaqujtia
mjx¶ pantzinco	mjxpantzinco
njno¶ mamaxauja	njnomamaxauja
caonax	ca·onax
onjcchi¶ uh	onjcchiuh
tlaio oaian	tlaiooaian
catezcac	ca·tezcac
catlavilpan	ca·tlavilpan
mjx pan¶ tzinco	mjxpantzinco
y nonax	yn·onax
matitzicolo	ma·titzicolo
compe¶ oaltia	compeoaltia
inj tlapilchioaliz	in·jtlapilchioaliz
veliujn¶	vel·iujn
macacan	maca·can
canjvin	can·jvin
y njuh	yn·juh
y nj tlachioal	yn·jtlachioal
quj¶ tocatiuh	qujtocatiuh
y njuhuj	yn·juhuj
y notlamjto	yn·otlamjto
y nj¶ tlatol	yn·jtlatol
y nomuchi	yno·muchi
y tlachi¶ oal	ytlachioal
tlapouh¶ quj	tlapouhquj
muchi¶ oa	muchioa
qujl¶ huja	qujlhuja
caticmononochilia	ca·ticmononochilia
catic¶ momaqujlia	ca·ticmomaqujlia
monequavi¶ tec	monequavitec
caizca	ca·izca
y mjlhujuh	ymjlhujuh
y njxcujname	yn·jxcujname
ti¶ motenoatzaz	timotenoatzaz
timo¶ caoaz	timocaoaz
Nicantlantica¶ injc	Nican·tlantica·injc
can¶ patzintique	canpa·tzintique
caie¶ iehoatl	ca·ie·iehoatl
teutioa¶ can	teutioacan
mononotz¶ que	mononotzque
caieomjto	ca·ie·omjto
amovel	amo·vel
inpanjca	in·panj·ca
mononotz¶ que	mononotzque
y njn	ynjn
tla¶ cotl	tlacotl
inquenjn	in·quenjn
tiene¶ quiz	tienequiz
intitla¶ qujxtiz	in·titlaqujxtiz
macan	ma·can
titla¶ maceoaa	titlamaceoaa
tictla¶ ca	tictlaca
tictla¶ caz	tictlacaz
tic qujxtiz	ticqujxtiz
tictlatla¶ calhuiz	tictlatlacalhuiz
y naco	yn·aco
vn¶ tzontli	vntzontli
po¶ liuiz	poliuiz
motlapil¶ chioal	motlapilchioal
ni¶ man	niman
ini¶ quac	iniquac
in¶ tlacan	intla·can
timotenoa¶ tzaz	timotenoatzaz
timocujtlax¶ culcaoaz	timocujtlaxculcaoaz
titepi¶ quiz	titepiquiz
y nj pan	yn·jpan
tiqujn¶ qujxtiz	tiqujnqujxtiz
y ni quac	yn·iquac
tlaitzcope¶ oalli	tlaitzcopeoalli
mjcam¶ pa	mjcampa
y njquac	yn·jquac
tioal mo cuepaz	tioalmocuepaz
y nj mjxpan¶	yn·jmjxpan
ma¶ macue	mamacue
otla mace¶ uh	otlamaceuh
y nj chan	yn·jchan
mone mjli zcuepa	monemjlizcuepa
qujl¶ mach	qujlmach
occepa	oc·cepa
Qujlma¶ ch	Qujlmach
mo¶ iol melaoaia	moiolmelaoaia
qujlma¶ ch	qujlmach
tzacujlti¶ lozque	tzacujltilozque
y nj n¶ tlapilchioal	yn·jntlapilchioal
y njc a¶ mo	ynjc·amo
qua te tla xililoz	quatetlaxililoz
y¶ njc	ynjc
Jntla pouhquj	Jn·tlapouhquj
y nj ixpan	yn·jixpan
y njlhujlo	yn·jlhujlo
catloque	ca·tloque
canaoque	ca·naoque
injlhujlo	in·jlhujlo
tepito¶ ton	tepitoton
qujn to qujlia	qujntoqujlia
te¶ teuh	teteuh
catetlatia	ca·tetlatia
te chi chinoa	techichinoa
mj ectlamantli	mjec·tlamantli
tlac¶ nelia	tlacnelia
iztatla¶ tilo	iztatlatilo
teculla¶ tilo	tecullatilo
tlatetzo¶ ionjlo	tlatetzoionjlo
tlatle¶ oatzalo	tlatleoatzalo
temaz¶ callatilo	temazcallatilo
tlanex¶ tlatilo	tlanextlatilo
ne¶ quaujtectli	nequaujtectli
qujxiptlatia¶ ia	qujxiptlatiaia
tla¶ cotonaloia	tlacotonaloia
oauh¶ qujltamalli	oauhqujltamalli
ce cencalpan	cecencalpan
quj¶ manjliaia	qujmanjliaia
qua¶ loia	qualoia
ini¶ quac	in·iquac
inomomanaco	in·omomanaco
inoiuh	in·oiuh
y njveveiooan	yn·jveveiooan
inqujcujcatia	in·qujcujcatia
quj¶ teccizpichilia	qujteccizpichilia
tetlaca¶ oaltiloia	tetlacaoaltiloia
motla¶ tiz	motlatiz
ian¶ cujcan	iancujcan
oauhqujltama¶ lli	oauhqujltamalli
ve¶ vetque	vevetque
injuhqujmatia	in·juh·qujmatia
quj maviztiliaia	qujmaviztiliaia
quj matia	qujmatia
initzintiliz	in·itzintiliz
i¶ nipeoaliz	in·ipeoaliz
i¶ cue	icue
caincoatepec	ca·in·coatepec
in veltiuh	inveltiuh
qui¶ mocuitlaviaia	quimocuitlaviaia
iuhqujnihujtelolotli	iuhqujn·ihujtelolotli
con¶ cujtiuetz	concujtiuetz
con¶ tlali	contlali
qujn¶ tlaxqujaia	qujntlaxqujaia
y naca	yn·aca
ca cotlein	caco·tlein
o cacic	ocacic
io ioli	ioioli
y camac¶	ycamac
cuj¶ iatl	cujiatl
y no io oac	yn·oiooac
ve vetque	vevetque
y la matque	ylamatque
nauhxi¶ uhtica	nauhxiuhtica
occenca	oc·cenca
mauiztililo¶ ia	mauiztililoia
motecujtotia¶ ia	motecujtotiaia
ynj¶ teucal	yn·jteucal
inon tlachpan	in·ontlachpan
co¶ cuizquja	cocuizquja
oquj¶ chtli	oqujchtli
qujn¶ mamatihuja	qujnmamatihuja
qujmoncaoa¶ ia	qujmoncaoaia
y niteupan	yn·iteupan
qujn nacazxapotlaia	qujnnacazxapotlaia
qujn na¶ cazcoionjaia	qujnnacazcoionjaia
qujn¶ machiotiaia	qujnmachiotiaia
yn tlaoan	yntlaoan
y maujoan	ymaujoan
ca te¶ pan	catepan
jnechichi¶ oal	jnechichioal
xiuhtotoa¶ macale	xiuhtotoamacale
mj¶ tzone	mjtzone
xiuhcooana¶ coche	xiuhcooanacoche
xiuhtezcatla¶ tlapanquj	xiuhtezcatlatlapanquj
y nj chimal	yn·jchimal
tlachi¶ el topile	tlachieltopile
vn navi¶	vnnavi
ne neuhque	neneuhque	
neteu¶ tiloia	neteutiloia
in teuh	inteuh
y¶ njquac	yn·jquac
to qujchti	toqujchti
y nj necaoa¶ liz	yn·jnecaoaliz
quj tla¶ liaia	qujtlaliaia
quj quaniz	qujquaniz
ne¶ netoltiloia	nenetoltiloia
me¶ nexoaliztli	menexoaliztli
qujtema¶ ceoaltiaia	qujtemaceoaltiaia
que¶ xiliuiliztli	quexiliuiliztli
ach¶ topa	achtopa
ce qujntin	cequjntin	
chilcaoa¶ ia	chilcaoaia	
qujn nepantla	qujnnepantla
ioalne¶ pantla	ioalnepantla
tlacujlol¶ atulli	tlacujlolatulli
y ni¶ pan	yn·ipan
nepan¶ tla	nepantla
io¶ tlaxcalli	iotlaxcalli	
quj quaia	qujquaia	
ne pantla	nepantla	
qujmatti¶ uh	qujmattiuh	
y nj tlat¶ quj	yn·jtlatquj	
quj cujcatiaia	qujcujcatiaia	
tlacotonalo¶ ia	tlacotonaloia	
y nj teupan	yn·jteupan	
macujl¶ tetl	macujltetl	
mj¶ toaia	mjtoaia	
con manjliaia	conmanjliaia	
macuil¶ tetl	macuiltetl	
y iol	yiol	
qujtlatzo¶ tzonjliaia	qujtlatzotzonjliaia
manti¶ via	mantivia	
tla¶ tlauhquj	tlatlauhquj	
quj mixip¶ tlatiaia	qujmixiptlatiaia
jlhujqujx¶ tililoia	jlhujqujxtililoia
iotlaxca¶ lli	iotlaxcalli
oalcaoa¶ loia	oalcaoaloia
y njx¶ qujch	yn·jxqujch
iauten¶ oaque	iautenoaque
qujn¶ oalcaoaia	qujnoalcaoaia
y njn malhoan	yn·jnmalhoan
y nj n¶ tla axioan	yn·jntlaaxioan
tzo¶ oalnenetl	tzooalnenetl
xone¶ cujlli	xonecujlli
tla¶ chololti	tlachololti
mo¶ tlacacoujaia	motlacacoujaia
quj xiptlatiaia	qujxiptlatiaia
ilhujqujx¶ tililoia	ilhujqujxtililoia
y nj nechichioal	yn·jnechichioal
qua chi chi¶ qujle	quachichiqujle
y nj tlamamal	yn·jtlamamal
vi¶ ton catlamamale	vitoncatlamamale
to¶ nalopanjtl	tonalopanjtl
que¶ tzaltzontecomaio	quetzaltzontecomaio
quetzaltzonte¶ come	quetzaltzontecome
tentla¶ paltica	tentlapaltica
y¶ tonalocac	ytonalocac
tlaixtla¶ palhvilli	tlaixtlapalhvilli
y¶ techpa	ytechpa
y nj¶ toca	yn·jtoca
y nj tech	yn·jtech
piquj¶ liloia	piqujliloia
imac¶ tia	imactia
tecooanotzaliz¶ tli	tecooanotzaliztli
tetla¶ tlaqualtiliztli	tetlatlaqualtiliztli
ne¶ cujtlaujloia	necujtlaujloia
y ntlacamo	yntlamaco
nuvizti¶ lilo	nuviztililo
y nj uhqujma	yn·juhqujma
te¶ cochizpan	tecochizpan
y namo	yn·amo
tinechma vizma¶ ti	tinechmavizmati
njcchi¶ oaz	njcchioaz
mjec¶ pa	mjecpa
mocu¶ ma	mocuma
in tlaqualli	in·tlaqualli
moco¶ coa	mococoa
y copac	ycopac
mel¶ tepotlamja	meltepotlamja
yn tla	yntla
y iomjio	yiomjio
cal¶ pole	calpole
y matijan	ymatijan
tla¶ oano	tlaoano
conj¶ titzopinja	conjtitzopinja
y notlathujc	yn·otlathujc
y nomacatl	yn·omacatl
con mjc¶ tia	conmjctia
ne¶ tlatlapanjlo	netlatlapanjlo
quaqua¶ lo	quaqualo
te¶ tlacaqujtilo	tetlacaqujtilo
temol¶ caoaltilo	temolcaoaltilo
y naquique	yn·aquique
maco¶ ia	macoia
y niquac	yn·iquac
ilhujuh qujcaz	ilhujuhqujcaz
mocujtlaxcol ixtlaoaia	mocujtlaxcolixtlaoaia
mopo¶ pooaia	mopopooaia
ontlaxtla¶ oaia	ontlaxtlaoaia
y naiamo	yn·aiamo
ih¶ vitzoncale	ihvitzoncale
y quauhquen tenchil	yquauhquentenchil
y cuechin	ycuechin
tez¶ catlatlapanquj	tezcatlatlapanquj
y nj xaic	yn·jxaic
ynj¶ nechichioal	yn·jnechichioal
y ticanacoch	yticanacoch
y ti¶ ca chimal	yticachimal
y tlachi¶ aia	ytlachiaia
y mac	ymac
acac¶ palli	acacpalli
tlaltete¶ cujn	tlaltetecujn
itli¶ lauh	itlilauh
tza¶ tzacutimanca	tzatzacutimanca
y napaztli	yn·apaztli
y teupan	yteupan
y tocaiocan	ytocaiocan
mococoa¶ ia	mococoaia
conjtia¶ ia	conjtiaia
y njtlilauh	ynjtlilauh
pilton¶ tli	piltontli
y njtlilauh	yn·jtlilauh
y na qujn	yn·aqujn
co¶ paltica	copaltica
qujvi¶ caia	qujvicaia
y chan	ychan
y njxiptla	yn·jxiptla
Jno acic¶	Jn·oacic
y notlaqua¶ loc	yn·otlaqualoc
y njxtlilton	yn·jxtlilton
y nomjtoti	yn·omjtoti
y non maceuh	yn·onmaceuh
tzacutima¶ ca	tzacutimaca
notzacutimanca	no·tzacutimanca
te tlaxima	tetlaxima
acoich¶ tec	aco·ichtec
mahavil¶ tia	mahaviltia
acaco	ac·aco
tlato¶ tia	tlatotia
qujx motlaia	qujxmotlaia
qujxcoma¶ caia	qujxcomacaia
quj¶ teixpantia	qujteixpantia
ynte¶ tlatlacul	yn·tetlatlacul
mocemjxtlil¶ popotz	mocemjxtlilpopotz
y nj cama¶ pa	yn·jcamapa
tecpa quachichiqujle	tecpaquachichiqujle
quetza¶ llo	quetzallo
y tonalopan	ytonalopan
y nj amaneapan	yn·jamaneapan
ynj¶ chimal	yn·jchimal
y iollo topil	yiollotopil
xopil¶ cuzque	xopilcuzque
y ama maxtli	yamamaxtli
co¶ iole	coiole
ito¶ ca	itoca
qujmo¶ teutiaia	qujmoteutiaia
I nin	Inin
quj¶ moteutiaia	qujmoteutiaia
caie¶ hoatl	ca·iehoatl
y tlanextil	ytlanextil
y ni¶ quac	yn·iquac
tla¶ qualli	tlaqualli
y ietl	yietl
qujte¶ peviliaia	qujtepeviliaia
quj cujcatiaia	qujcujcatiaia
y niveveiooan	yn·iveveiooan
y njlamaiooan	yn·jlamaiooan
J nj nechichioal	Jn·jnechichioal
amaca¶ le	amacale
ama¶ maxtle	amamaxtle
to¶ naloio	tonaloio
capitu¶ lo	capitulo
yni¶ toca	yn·itoca
A naoatl	Anaoatl
in¶ teuh	inteuh
y ni tequiuh	yn·itequiuh
y tlachioal	ytlachioal
y ni neix ca¶ vil	yn·ineixcavil
te xoxaia	texoxaia
totomonjliz¶ tli	totomonjliztli
papala niliztli	papalaniliztli
caca oatiliztli	cacaoatiliztli
ix¶ tenpipixqujliztli	ixtenpipixqujliztli
ixtamacolici¶ uiztli	ixtamacoliciuiztli
ix¶ nacapachiuiliztli	ixnacapachiuiliztli
J na qujn	Jn·aqujn
cu¶ culiztli	cuculiztli
mone¶ toltiaia	monetoltiaia
y nj icoaio	yn·jicoaio
tla¶ painaltiaia	tlapainaltiaia
mjequjn¶ tin	mjequjntin
eoaio¶ tiuj	eoaiotiuj
chichipica¶ tiuj	chichipicatiuj
qujnnecalil¶ tiaia	qujnnecaliltiaia
inix¶ qujchti	in·ixqujchti
mjhivin¶ tia	mjhivintia
amjquizmauh¶ que	amjquizmauhque
iaotlaveli¶ loque	iaotlaveliloque
mo ia¶ omamachtiaia	moiaomamachtiaia
mjcaliz¶ que	mjcalizque
y naiac	yn·aiac
mj toaia	mjtoaia
ynjuh	yn·juh
yntotecti	yn·totecti
qujmochol¶ cuzcatia	qujmocholcuzcatia
qujntlaoan¶ tia	qujntlaoantia
to¶ tomonja	totomonja
ma¶ njctlamaniliz	manjctlamaniliz
J ni nechichi¶ oal	Jn·inechichioal
tenma¶ xaltic	tenmaxaltic
contla¶ liticac	contlaliticac
conma¶ qujticac	conmaqujticac
ma¶ lli	malli
tecujtlana¶ coche	tecujtlanacoche
ichi¶ mal	ichimal
chi¶ caoaztli	chicaoaztli
y ieoaio	yieoaio
y¶ nj toca	yn·jtoca
quj¶ maviztiliaia	qujmaviztiliaia
amati¶ ca	amatica
y njntopil	yn·jntopil
y motlatopil	ymotlatopil
yn¶ inenemja	yni·nenemja
y nj motlatocaia	ynj·motlatocaia
in ca¶ pa	incapa
qujtilque¶ tza	qujtilquetza
quj¶ copaltemjlia	qujcopaltemjlia
y nj nteouh	yn·jnteouh
y ia catecutli	yiacatecutli
qujmatataquj¶ lia	qujmatataqujlia
y teicneliliz	yteicneliliz
aciti¶ nemj	acitinemj
y nitoca	yn·itoca
cala¶ qujnj	calaqujnj
tle¶ in	tlein
ana¶ oatl	anaoatl
tonalciiauh¶ tinemj	tonalciiauhtinemj
mo¶ ciauhpouhtinemj	mociauhpouhtinemj
mociauhpo¶ uhtiuj	mociauhpouhtiuj
mociauh¶ quetztiuj	mociauhquetztiuj
ymjx¶ qua	ymjxqua
qujma¶ cujtiuj	qujmacujtiuj
atla¶ uhtli	atlauhtli
quj¶ tlecauja	qujtlecauja
in mo¶ liepi	inmoliepi
mo¶ quequetza	moquequetza
quj ci iavj	qujciiavj
qujhi¶ iouja	qujhiiouja
chalchi¶ ujtl	chalchiujtl
y na poconalli	yn·apoconalli
xi¶ uhtototl	xiuhtototl
qua¶ uhtli	quauhtli
tequan eoatl	tequaneoatl
ocelu¶ petlatl	ocelupetlatl
yiaca¶ tecutli	yiacatecutli
ixqujch caana	ixqujchca·ana
a¶ quaujtl	aquaujtl
y natzaccaiutl	yn·atzaccaiutl
intla¶ nel	intlanel
intz acuj	in·tzacuj
tza¶ cutica	tzacutica
on nemj	onnemj
cala¶ quj	calaquj
nechichi¶ oaliztica	nechichioaliztica
tlatol¶ tica	tlatoltica
cha¶ neque	chaneque
otlanecomal¶ tique	otlanecomaltique
qujn¶ poiomjctia	qujnpoiomjctia
qujn chillatilia	qujnchillatilia
a¶ ca	aca
y nocne	yn·oc·ne
te¶ matitlanpa	tematitlanpa
quj¶ oal nonotzaia	qujoalnonotzaia
y¶ apoconaltenteuh	yapoconaltenteuh
qujmavizio¶ tia	qujmaviziotia
y nj¶ quac	yn·jquac
y nj miloch	yn·jmiloch
yn necuepal	ynnecuepal
y no tlal¶ techacico	yn·otlaltechacico
puch¶ teca	puchteca
mote¶ ittitiaia	moteittitiaia
quj maviztiliaia	qujmaviztiliaia
y nitopil	yn·itopil
y nj¶ tlaccaia	yn·jtlaccaia
cal¶ pulco	calpulco
qujtla¶ manjlia	qujtlamanjlia
y nj tlaquaia	yn·jtlaquaia
te¶ altiz	tealtiz
y nj teouh	yn·jteouh
qujn moteutiaia	qujnmoteutiaia
ac¶ xomucujl	acxomucujl
cochi¶ metl	cochimetl
ia ca pitzaoac	iacapitzaoac
quj io¶ cuja	qujiocuja
y iollo tlama	yiollotlama
caaltiz	ca·altiz
con¶ covaia	concovaia
azcapu¶ tzalco	azcaputzalco
motlapapa¶ tilia	motlapapatilia
qujn cuecuepa	qujncuecuepa
quj mjhitta	qujmjhitta
y na çan	yn·açan
y na çan¶	yn·açan
tlaca¶ melaoaque	tlacamelaoaque
intlaciuhca	intlaciuh·ca
qujn¶ mietizque	qujnmietizque
y ni pan	yn·ipan
panquetzaliz¶ tli	panquetzaliztli
vi¶ tzilubuchtli	vitzilubuchtli
qujnchichi¶ oaia	qujnchichioaia
qujn tlamamaca	qujntlamamaca
y nj uh quj	yn·juhquj
y ne chichi¶ oal	ynechichioal
y ia ca tecutli	yiacatecutli
y na¶ iamo	yn·aiamo
qujn¶ teittitiaia	qujnteittitiaia
quj mjx nextia	qujmjxnextia
quj temachitia	qujtemachitia
y nj tlaaltilhoan	yn·jtlaaltilhoan
tlacotilma¶ tli	tlacotilmatli
y njn tech	yn·jntech
ti¶ anquizco	tianquizco
tlatlah¶ tlamj	tlatlahtlamj
y njn cuje	yn·jncuje
mo mi¶ quiz quequeloa	momiquizquequeloa
cujca matinj	cujcamatinj
ioliz matquj	iolizmatquj
y njxe	yn·jxe
quj qujxtiaia	qujqujxtiaia
tla¶ machiuhquj	tlamachiuhquj
in tla	intla
vellaqual¶ chioa	vellaqualchioa
yia¶ uh	yiauh
in tlaqual	intlaqual
qujx¶ tiloia	qujxtiloia
qujn motlacacioaoatiaia	qujnmotlacacioaoatiaia
motlatla tla¶ li	motlatlatlali
y temjlo	ytemjlo
teucuj¶ tlanacoche	teucujtlanacoche
y nj tilma	yn·jtilma
oio oale	oiooale
tecca¶ que	teccaque
y nj chi¶ mal	yn·jchimal
y tlaccaia	ytlaccaia
otla¶ topile	otlatopile
tla¶ loque	tlaloque
y mjxcoian	ymjxcoian
in cat¶ jan	incatjan
tol cuechi¶ uhque	tolcuechiuhque
y tech¶	ytech
y nic palchioa¶ liztli	yn·icpalchioaliztli
coco caoaia	cococaoaia
quj qujx¶ tia	qujqujxtia
te altia	tealtia
te pan	tepan
tol¶ patlactli	tolpatlactli
y nj quac¶	yn·jquac
ilh ujuh qujcaia	ilhujuhqujcaia
te¶ papaca	tepapaca
qujtze¶ tzeloa	qujtzetzeloa
aoa¶ chtli	aoachtli
tlaih tlanjliloia	tlaihtlanjliloia
qujxe¶ oaia	qujxeoaia
y¶ mac	ymac
ie¶ tinemj	ietinemj
teatzel¶ hvia	teatzelhvia
il¶ hujuh	ilhujuh
nen majan	nenmajan
oc¶ noce	oc·no·ce
qujchi¶ chioaia	qujchichioaia
pe¶ tlachiuhquj	petlachiuhquj
y chan¶	ychan
tea¶ tzelhujtiuh	teatzelhujtiuh
iuh¶ qujn	iuhqujn
qujmic neliz	qujmicneliz
iuh qujn¶	iuhqujn
y vic	yvic
mocujtlaxculix tlaoaia	mocujtlaxculixtlaoaia
y na caca	yn·acaca
y¶ axca	yaxca
njc¶ nenqua	njcnenqua
njc nenepo¶ lo	njcnenepolo
njc nixcauj	njcnixcauj
on qualo	onqualo
on po poliuj	onpopoliuj
on¶ mjtoti	onmjtoti
tecu¶ tli	tecutli
maca quen	ma·caquen
nj nonemjtiz	njnonemjtiz
y na ciuhquj	yn·ac·iuhquj
quj mati	qujmati
aciuh¶ quj	ac·iuhquj
nech moma qujliz	nechmomaqujliz
quj¶ momacaviliz	qujmomacaviliz
y nixiptla	yn·ixiptla
muchioa¶ ia	muchioaia
y nichan	yn·ichan
muchi tlacatl	muchitlacatl
y¶ nj oaniolque	yn·joaniolque
acocitla	acoc·itla
y nj calpulco¶	yn·jcalpulco
pe¶ tlateteca	petlateteca
tlatzetze¶ loa	tlatzetzeloa
tle¶ tlalia	tletlalia
tla¶ tetzcaliuhtoc	tlatetzcaliuhtoc
tlatetzcaliuhti¶ manj	tlatetzcaliuhtimanj
ic palteteca	icpalteteca
mix¶ tlilhuj	mixtlilhuj
mjch chiaujticac	mjchchiaujticac
ama¶ cale	amacale
y ia ma cuexpal	yiamacuexpal
amamax¶ tle	amamaxtle
atlacue¶ conanchimale	atlacueconanchimale
tepicto¶ ton	tepictoton
y njnoan	yn·jnoan
y noan	ynoan
y ntlaloque	yn·tlaloque
te¶ picto	tepicto
quj mon pi qujia	qujmonpiqujia
quj¶ mixiptlaiotiaia	qujmixiptlaiotiaia
y naqujn¶	yn·aqujn
quaqua¶ uhtia	quaquauhtia
y na¶ qujn	yn·aqujn
mo¶ netoltiaia	monetoltiaia
inchal¶ chivitl	in·chalchivitl
intlaloc	in·tlaloc
popucate¶ petl	popucatepetl
quj pi quiz	qujpiquiz
quj mi¶ xiptlatiaia	qujmixiptlatiaia
te te pe	tetepe
tzoa¶ lli	tzoalli
qujntla¶ catlachieltiaia	qujntlacatlachieltiaia
tlacatlachixti¶ catca	tlacatlachixticatca
aiecu¶ tli	aiecutli
y ntlatquj	yntlatquj
qujn piqujia	qujnpiqujia
qujn chichi¶ oaia	qujnchichioaia
qujn que quenti¶ aia	qujnquequentiaia
ce quj	cequj
amatete¶ vitl	amatetevitl
tlaolchacha¶ patzalli	tlaolchachapatzalli
quj pipiloa¶ ia	qujpipiloaia
quj nene tech¶ ilpiaia	qujnenetechilpiaia
quj nene tech caloaia	qujnenetechcaloaia
y mjx pan	ymjxpan
itzacuto¶ que	itzacutoque
te¶ teujtl	teteujtl
te picme	tepicme
y nitech	yn·itech
te¶ tzotzonticac	tetzotzonticac
necoc campa	necoccampa
tlaix¶ tla pantli	tlaixtlapantli
ymix¶ pan	ymixpan
chalchiuhxi¶ calli	chalchiuhxicalli
y¶ njn tequiuh	yn·jntequiuh
qujn chichioaia	qujnchichioaia
machice que	machiceque
qujn¶ tlaliaia	qujntlaliaia
qujn tlalhujaia	qujntlalhujaia
qujn mol caoaltiaia	qujnmolcaoaltiaia
y no ie	yn·o·ie
cauh que¶	cauhque
qujnto ca¶ viia	qujntocaviia
qujn cujcatia	qujncujcatia
qujn tlamanjlia	qujntlamanjlia
ta¶ malololli	tamalololli
qujn macaia	qujnmacaia
quj¶ manaia	qujmanaia
y mjxpa	ymjxpa
tlama¶ cazque	tlamacazque
qujn tlamacaia	qujntlamacaia
qujn maqui¶ qujxiliaia	qujnmaquiqujxiliaia
qujn¶ pichiliaia	qujnpichiliaia
haa¶ vienj	haavienj
tececemel¶ tianj	tececemeltianj
notla macoia	no·tlamacoia
qujn mictia¶	qujnmictia
y ntepicme	yn·tepicme
qujn quechcotona	qujnquechcotona
qujn¶ quecheuj	qujnquecheuj
qujn quechilacatzoa	qujnquechilacatzoa
ca¶ tepan	catepan
qujn cemololoa	qujncemololoa
y notlatvic	yn·otlatvic
y nitlacoanotzalhoan	yn·itlacoanotzalhoan
ynj¶ cooaoan	yn·jcooaoan
mopixto¶ que	mopixtoque
motlaoanca¶ tlalia	motlaoancatlalia
chicaoa¶ que	chicaoaque
y nj lamat¶ que	yn·jlamatque
in nemac	innemac
viuj¶ loa	viujloa
y naca	yn·aca
mocho quj litiuh	mochoqujlitiuh
y naca¶	yn·aca
mo¶ mamantiuh	momamantiuh
tetzatzi¶ litiuh	tetzatzilitiuh
on nen¶ ca	onnenca
y nitequjuh	yn·itequjuh
y njchiujl	yn·jchiujl
tla¶ ca quj tiloia	tlacaqujtiloia
mocaoa¶ ia	mocaoaia
quj necaujliaia	qujnecaujliaia
mo piaia	mopiaia
co¶ chia	cochia
in manel	inmanel
tlach taca¶	tlachtaca
ocon¶ palo	oconpalo
y nite	yn·ite
inaca¶	in·aca
quj cue¶ cuetza	qujcuecuetza
qui cue cuetza	quicuecuetza
iexi¶ cuecuechca	iexicuecuechca
ten¶ papatlaca	tenpapatlaca
ten viviioca	tenviviioca
ma¶ copichauj	macopichauj
apeoa¶ lo	apeoalo
y napeoa	yn·apeoa
yni¶ oaniolque	yn·ioaniolque
incen¶ tlaca	in·centlaca
icujtlax¶ colloc	icujtlaxcolloc
intla chioal vctli	in·tlachioalvctli
y nte¶ piqujnj	yn·tepiqujnj
coaci¶ vi	coacivi
te¶ piquj	tepiquj
quj¶ neltilia	qujneltilia
yn netol	ynnetol
y njn ne chichioal	yn·jnnechichioal
y njn¶ tlaquen	yn·jntlaquen
y njmama neapan	yn·jmamaneapan
y nj moztopil	yn·jmoztopil
y njntlapetla¶ njlquauh	yn·jntlapetlanjlquauh
y nj maiauhcocul	yn·jmaiauhcocul
y njn chalchiuhxical	yn·jnchalchiuhxical
coqujtecon¶ totonti	coqujtecontotonti
concaoa¶ ia	concaoaia
contepe¶ oaia	contepeoaia
ytoca¶ iocan	ytocaiocan
tlatla¶ culli	tlatlaculli
catete¶ pexiuja	ca·tetepexiuja
tetza¶ vittonj	tetzavittonj
a¶ mo	amo
chico ittolonj	chicoittolonj
yn¶ oan	ynoan
centzo¶ totochti	centzototochti
in nacaio	innacaio
y ni Jauh tecatl	yn·iJauhtecatl
tlil¶ hoa	tlilhoa
Jzquj tecatl	Jzqujtecatl
Tlalte¶ caiooa	Tlaltecaiooa
tepuz¶ tecatl	tepuztecatl
Col¶ hoatzincatl	Colhoatzincatl
ipeuh çan	ipeuhçan
A¶ cuecucexatl	Acuecucexatl
in ma	inma
coio aca	coioaca
uj tzilupuchco	ujtzilupuchco
nauh xiujtl	nauhxiujtl
qujtz¶ tia	qujtztia
mj qui	mjqui
inj coac	in·jcoac
auj tzutl	aujtzutl
oalla¶ que	oallaque
o apachiuh	oapachiuh
qua¶ loc	qualoc
intlaioatimanca	in·tlaioatimanca
tziuh¶ coaca	tziuhcoaca
chia¶ pan	chiapan
izo atlan	izoatlan
xoco¶ nochco	xoconochco
coioa¶ can	coioacan
teno¶ chtitlan	tenochtitlan
M otecucuma	Motecucuma
tla¶ tocat	tlatocat
caxtol xiuitl¶	caxtolxiuitl
te¶ pan	tepan
oqujtla¶ lica	oqujtlalica
inixillan	in·ixillan
y nivitl	yn·ivitl
acoq'¶ chivili	ac·oq'chivili
injnnan	in·jnnan
ino qujttaque	in·oqujttaque
aqujnocotzti	aqujn·ocotzti
techavilq`x¶ tia	techavilq`xtia
injn vel¶ tiuh	in·jnveltiuh
qui mjlvi	quimjlvi
no¶ qujchtioan	noqujchtioan
initicca	in·itic·ca
aco quj chivili	ac·oqujchivili
qujio¶ llaliaia	qujiollaliaia
quilhuj¶ aia	quilhujaia
njc¶ mati	njcmati
mo¶ iollali	moiollali
iuh qui¶ njuhcantlama	iuhquin·juhcantlama
ino qujma	in·oqujma
mote quj pacho	motequjpacho
injtic	in·jtic
inj coneuh	in·jconeuh
macaximomauhti	maca·ximomauhti
ino qujcac	in·oqujcac
initlatol	in·itlatol
motlali y njiollo	motlali·yn·jiollo
iene	ie·ne
incentzonvitznaoa	in·centzonvitznaoa
ino quj cetla¶ lique	in·oqujcetlalique
ino quj cemjtoq¶ ica	in·oqujcemjtoq·ica
quj mictizque	qujmictizque
injn nan	in·jnnan
caotlapinauhti	ca·otlapinauhti
cacenca	ca·cenca
muchi¶ caoaia	muchicaoaia
iuh quj	iuhquj
y njiollo	yn·jiollo
Coiolxauh¶ quj	Coiolxauhquj
qujn ioleoaia	qujnioleoaia
qujniol¶ lo cocoltiaia	qujniollococoltiaia
inj oqujchtioa	in·joqujchtioa
inma¶ cuele	in·macuele
ince¶ tzonvitznaoa	in·cetzonvitznaoa
moce¶ caoa	mocecaoa
inie¶ hoantin	in·iehoantin
tla¶ quauicujaia	tlaquauicujaia
injntzon	in·jntzon
injnquatzon	in·jnquatzon
qujtla¶ litinenca	qujtlalitinenca
qujto¶ oaia	qujtooaia
vitzilobuch¶ tli	vitzilobuchtli
notlatzi¶ ne	notlatzine
njc mati	njcmati
tleticmomachitia	tle·ticmomachitia
ieque¶ ne	iequene
inocentetix¶ injntlatol	in·ocentetix·in·jntlatol
motlamama¶ caque	motlamamacaque
inj ma¶ matlatquj	in·jmamatlatquj
injn miuh	in·jnmiuh
Coiolxauh quj	Coiolxauhquj
qujil¶ pique	qujilpique
momama¶ tivi	momamativi
tetec pantivi	tetecpantivi
tlatla¶ mantitivi	tlatlamantitivi
amat itech	amatitech
qui¶ oalilhuj	quioalilhuj
ievitze	ie·vitze
caie¶ coa xalpan	ca·ie·coaxalpan
vi¶ tze	vitze
caietlatlacapan	ca·ie·tlatlacapan
inqujnonotz az	in·qujnonotzaz
quilhujca	quilhuj·ca
Qua¶ vitl	Quavitl
caietlatlacapan	ca·ie·tlatlacapan
caie	ca·ie
tlaxontlachie	tla·xontlachie
njmanic	njman·ic
noceppa	no·ceppa
on¶ can	oncan
cuj cacali	cujcacali
tlael napaloa	tlaelnapaloa
cioa¶ coatl	cioacoatl
mo¶ chitlacatl	mochi·tlacatl
No nopilhoantzitzi¶	Nonopilhoantzitzi
yit oalco	yitoalco
quj te¶ manque	qujtemanque
nauil huitl	nauilhuitl
mo¶ tocac	motocac
mozca¶ li	mozcali
mo¶ tlapo	motlapo
nj man¶	njman
quj nonotzato	qujnonotzato
mo¶ tecucuma	motecucuma
quj¶ pouili	qujpouili
nj mj tzilhujco	njmjtzilhujco
onj¶ nozcali	onjnozcali
quil¶ huj	quilhuj
canievitze	can·ie·vitze
njmanjc	njman·jc
i¶ cac	icac
Vi¶ tzilobuchtli	Vitzilobuchtli
njmanitlatquj	njman·itlatquj
inichi¶ mal	in·ichimal
tlatla¶ an	tlatlaan
ynico necujtl	yn·iconecujtl
mj toaia	mjtoaia
moquapo¶ tonj	moquapotonj
inanacaz¶ tlan	inanacaztlan
ipil nechioal	ipilnechioal
ic xitlan	icxitlan
y¶ iopoch copa	yiopochcopa
injxocpal	in·jxocpal
v¶ mexti	vmexti
injc xi	in·jcxi
injacol	in·jacol
Tochancal quj	Tochancalquj
con¶ tlati	contlati
xjuh coatl	xjuhcoatl
Coiol xauhquj	Coiolxauhquj
initzontecon¶ vmpa	in·itzontecon·vmpa
ommo cauh	ommocauh
injtenpa	in·jtenpa
coa¶ tepetl	coatepetl
injma	in·jma
injcxi	in·icxi
initlac	in·itlac
qujn oaltemovia	qujnoaltemovia
ieoaleoa	ie·oaleoa
intla naquj	intlan·aquj
q'n¶ o altepeoa	q'noaltepeoa
inoqujma¶ xitico	in·oqujmaxitico
intlalchi	in·tlalchi
qujniaiaoa¶ lochti	qujniaiaoalochti
q'n¶ tlatlaiaoalochti	q'ntlatlaiaoalochti
iaiaoa¶ lochti	iaiaoalochti
quio aloiuhtivia	quioaloiuhtivia
ocnequi¶ oaloioviaia	ocnequioaloioviaia
oalmo chimal vitectiuia	oalmochimalvitectiuia
aoctlevel	aoc·tle·vel
aocmovel quitzacuilique	aocmo·vel·quitzacuilique
qujnce¶ meviti	qujncemeviti
qujn centepotz¶ ti	qujncentepotzti
qujn popolo	qujnpopolo
qujn iaiaoa¶ lochti	qujniaiaoalochti
alte¶ petl	altepetl
Caieix¶ qujch	Ca·ie·ixqujch
catehoatl	ca·tehoatl
mocatzonquj¶ ca	moca·tzonqujca	
C cuj tlaoa	Ccujtlaoa
tlato cat¶	tlatocat
o¶ iuh	oiuh
nauh¶ xiujtl	nauhxiujtl
ie¶ hoantin	iehoantin
quj peuhque	qujpeuhque
qujiao alotoc	qujiaoalotoc
ini pilhoan	in·ipilhoan
fra¶ cisco	fracisco
tlateoto¶ quiliztli	tlateotoquiliztli
tlanelto qujliztli	tlaneltoqujliztli
es¶ pañoles	españoles
exiujtliepan	exiujtl·iepan
iau quj cato	iauqujcato
mj qujto	mjqujto
ma¶ tlactli	matlactli
teuetz qujti	teuetzqujti
cas¶ tolli	castolli
otlato¶ catque	otlatocatque
poli¶ uj	poliuj
oqujn¶ cuepilique	oqujncuepilique
inix qujch¶ ica	in·ixqujchica
itech¶ pa	itechpa
Qua¶ quappitzaoac	Quaquappitzaoac
iepoalxi¶ ujtl	iepoalxiujtl
tena¶ io çan	tenaioçan
io an¶	ioan
tlato¶ cat	tlatocat
omo¶ teneuhque	omoteneuhque
cempoal xiujtl	cempoalxiujtl
aculhoa¶ catl	aculhoacatl
injxqujch¶	in·jxqujch
in¶ ic	inic
mo cocolique	mococolique
injtex	in·jtex
axaia¶ ca	axaiaca
quj¶ iauchiuh	qujiauchiuh
tlati¶ lulca	tlatilulca
moquiujx¶ tli	moquiujxtli
canjnoma	can·jnoma
chico¶ xiujtl	chicoxiujtl
tlato cati	tlatocati
tlama¶ ujcolli	tlamaujcolli
tla¶ mjz	tlamjz
quauhnoch¶ tlj	quauhnochtlj
ma cujlli	macujlli
intla¶ tilulco	in·tlatilulco
mu¶ chiuh	muchiuh
cocoliz¶ tli	cocoliztli
peoalo¶ que	peoaloque
nj çan¶	njçan
intlatilul¶ co	in·tlatilulco
vitznaoatlailo¶ tlac	vitznaoatlailotlac
quechpo caoaliztli	quechpocaoaliztli
matlacxi¶ ujtl	matlacxiujtl
iz¶ qui	izqui
Quj¶ peoalti	Qujpeoalti
tlato caiutl	tlatocaiutl
napo¶ alilhujtl	napoalilhujtl
atleipan¶	atle·ipan
techotla¶ latzin	techotlalatzin
matlac¶ xiujtl	matlacxiujtl
anotle	ano·tle
amotle	amo·tle
intla¶ tocat	in·tlatocat
macujl xiujtl¶	macujlxiujtl
neca¶ oalcoiotzin	necaoalcoiotzin
iepoal¶ xiujtl	iepoalxiujtl
matlac xiujtl	matlacxiujtl
imomextin	im·omextin
necaoalco¶ iotzin	necaoalcoiotzin
injc¶ palli	in·jcpalli
iehoa¶ tl	iehoatl
macujl xiujtl	macujlxiujtl
te¶ cocoltzin	tecocoltzin
mar¶ ques	marques
quj mpeuh	qujmpeuh
ixtlil xochitzin	ixtlilxochitzin
chi¶ cuexiujtl	chicuexiujtl
qujuj catiuja	qujujcatiuja
iehoa¶ tin	iehoatin
tla¶ uellalali	tlauellalali
co¶ anacuchtli	coanacuchtli
ioion¶ tzin	ioiontzin
te¶ tlaueuetz qujtitzin	tetlaueuetzqujtitzin
chico acexiujtl	chicoacexiujtl
hernan¶ do	hernando
ce¶ poal xiujtl	cepoalxiujtl
ix qujch	ixqujch
caxtolpoal xiujtl¶	caxtolpoalxiujtl
ix quich	ixquich
ca¶ uitl	cauitl
vexu¶ tla	vexutla
acul¶ oaque	aculoaque
acul¶ hoacan	aculhoacan
Iz cate	Izcate
ue¶ xutla	uexutla
caxtol xi¶ ujtl	caxtolxiujtl
te¶ cutli	tecutli
cempoal xiujtl¶	cempoalxiujtl
quatla¶ uice	quatlauice
tlatocatvmpoal¶ xiujtl	tlatocat·vmpoalxiujtl
vmpoal¶ xiujtl	vmpoalxiujtl
exi¶ ujtl	exiujtl
tequjt¶ que	tequjtque
acul¶ hoaque	aculhoaque
xi¶ lotzin	xilotzin
cempoal¶ xiujtl	cempoalxiujtl
i¶ tlacauhtzin	itlacauhtzin
caxtol¶ xiujtl	caxtolxiujtl
i¶ toca	itoca
vmpoal xiujtl	vmpoalxiujtl
tlatoa¶ nj	tlatoanj
quez quj tzon xiujtl	quezqujtzonxiujtl
injxquichica	in·jxquichica
mjie¶ qujntin	mjiequjntin
injn tlatollo	in·jntlatollo
oxixi¶ tin	oxixitin
opoliuh¶ que	opoliuhque
inj pan	in·jpan
caxtol poalxiujtl	caxtolpoalxiujtl
ma¶ tlacxiujtl	matlacxiujtl
tlal¶ maceoaco	tlalmaceoaco
o motecaco	omotecaco
chi chime¶ ca	chichimeca
aocmovel	aocmo·vel
qujn caoaia	qujncaoaia
inovel	in·ovel
maix quich	ma·ixquich
aocmovel¶ qujn caoaia	aocmo·vel·qujncaoaia
mo¶ tlapalo	motlapalo
qujn tocac	qujntocac
ian cuj çan	iancujçan
inteiacan cauh	inteiacancauh
tlato cauh¶	tlatocauh
inj xiuhtzin¶	in·jxiuhtzin
inj·xiuhtzin	in·jxiuhtzin
machi¶ otl	machiotl
oal¶ huj	oalhuj
nj¶ can	njcan
neica¶ ujloia	neicaujloia
tlatem machoia	tlatemmachoia
oalmo¶ quetzaia	oalmoquetzaia
tlaceujloz	tla·ceujloz
ca ate quiaia	caatequiaia
quj¶ ceujznequja	qujceujznequja
ilhuj ce	ilhujce
ito caio çan	itocaioçan
a¶ mono	amono
caca	ca·ca
ie¶ teetia	ieteetia
inj¶ quj caiampa	in·jqujcaiampa
iuh qujntlexuchtli	iuhqujn·tlexuchtli
pi¶ pixauhtiuh	pipixauhtiuh
inj cujtlapil	in·jcujtlapil
tlama¶ itlaujaia	tlamaitlaujaia
iuh qujnto cujlciotl	iuhqujn·tocujlciotl
quj ttilico	qujttilico
to¶ natiuh	tonatiuh
octlaca	oc·tlaca
iuh qujntezcatl¶	iuhqujn·tezcatl
teuj¶ lacachtic	teujlacachtic
iuh quj	iuhquj
vn¶ pa	vnpa
inmamal¶ hoaz	inmamalhoaz
anqui mati	anquimati
ono co njttac	onoconjttac
aca¶ me	acame
aoctle	aoc·tle
quj toque	qujtoque
espa¶ ñoles	españoles
inj x¶ qujch ica	in·jxqujchica
omma¶ tlactli	ommatlactli
quetzal¶ coatl	quetzalcoatl
quj mamacaque	qujmamacaque
motlali¶ que	motlalique
nj maniaque	njman·iaque
cho¶ lolan	chololan
qujn¶ mjctique	qujnmjctique
quj na mj qujto	qujnamjqujto
injtzalan	in·jtzalan
injztac	in·jztac
mote¶ nehoa	motenehoa
ooalmo cuep	ooalmocuep
mj¶ iequjntin	mjiequjntin
españo¶ les	españoles
caca¶ oatioac	cacaoatioac
Inj pan	In·jpan
omo¶ tlalique	omotlalique
qujn iau chiuhque	qujniauchiuhque
quj mj calque	qujmjcalque
occeppa¶	oc·ceppa
oalmocentla¶ lique	oalmocentlalique
inj pampa	in·jpampa
qujntla¶ neltoqujtique	qujntlaneltoqujtique
nechi¶ chioaia	nechichioaia
injzqujtlamantli	in·jzqujtlamantli
injn¶ techqujtlaliaia	in·jntech·qujtlaliaia
Chi¶ malli	Chimalli
xiuh tototica	xiuhtototica
quet¶ zalpapalotl	quetzalpapalotl
i¶ namjc	inamjc
teucuj¶ tlatl	teucujtlatl
teo cuj tlatica	teocujtlatica
teu¶ cuj tlapapalotl	teucujtlapapalotl
que¶ tzal xopilli	quetzalxopilli
inj eoaio	in·jeoaio
teu cujtla¶ quacalalatli	teucujtlaquacalalatli
iquetzal qua quauh	iquetzalquaquauh
teu¶ cujtla quacalalatli	teucujtlaquacalalatli
teu¶ cujtlatl	teucujtlatl
quetzal¶ panjtl	quetzalpanjtl
quetzalteco¶ maio	quetzaltecomaio
teu¶ cujtlapanjtl	teucujtlapanjtl
quetzal¶ tzontecomaio	quetzaltzontecomaio
Itz papalotl	Itzpapalotl
tlaco¶ tlanquj	tlacotlanquj
teucuj¶ tlaio	teucujtlaio
inj tlan	in·jtlan
inj izti	in·jizti
tlaco¶ iujtl	tlacoiujtl
iquetzal qua quauh	iquetzalquaquauh
Xochi¶ quetzalpapalotl	Xochiquetzalpapalotl
teu cujtlatl	teucujtlatl
inj¶ namjc	in·jnamjc
Iz¶ tac	Iztac
qua xolotl	quaxolotl
inj namjc	in·jnamjc
Caquan tzontli	Caquantzontli
que¶ tzallo	quetzallo
teucuj tlaio	teucujtlaio
teu cuj tlatl	teucujtlatl
Xoxouh¶ quj	Xoxouhquj
tlachiuh¶ tli	tlachiuhtli
tzitzi¶ mjtl	tzitzimjtl
iquetzal¶ temal	iquetzaltemal
quetzalti¶ ca	quetzaltica
ixquateucujtla¶ io	ixquateucujtlaio
imamalaca quetzal	imamalacaquetzal
teu cuj¶ tlaio	teucujtlaio
inj iaca¶ metz	in·jiacametz
que¶ tzaltecomaio	quetzaltecomaio
teucujtla copilli	teucujtlacopilli
quetzal¶ tonatiuh	quetzaltonatiuh
Xiloxochi patzactli	Xiloxochipatzactli
que¶ tzalli	quetzalli
injizoaio	in·jizoaio
inj tecpaio	in·jtecpaio
inj canaoacan	in·jcanaoacan
maman¶ tiuh	mamantiuh
tlacomal¶ tectli	tlacomaltectli
injn tlaqual	in·jntlaqual
motzonte¶ quj	motzontequj
qujntlatzontequj¶ liaia	qujntlatzontequjliaia
Ve¶ uej	Veuej
tla¶ olli	tlaolli
qujntlaxtla¶ ujli	qujntlaxtlaujli
Inon canjn	In·oncan·jn
amotleveca¶ oaia	amo·tle·vecaoaia
iciuh¶ ca	iciuhca
ca¶ qujtiloia	caqujtiloia
quj cnjuh¶ chioaia	qujcnjuhchioaia
atletlaxtlaujltica	atle·tlaxtlaujltica
qujx¶ pachoaia	qujxpachoaia
tia¶ caoan	tiacaoan
injn nenonotz aian	in·jnnenonotzaia·n
injnchan	in·jnchan
cuj canj¶ me	cujcanjme
inj¶ pampa	in·jpampa
noiuhquj	no·iuhquj
me¶ oaz	meoaz
injntla¶ tol	in·jntlatol
jnnechichi¶ oal	jnnechichioal
iniuhquj	in·iuhquj
qujnmocujtlauj¶ aia	qujnmocujtlaujaia
tequa¶ nj	tequanj
oco¶ tochtli	ocotochtli
injn nechichioaia	in·jnnechichioaia
A¶ poconal nacochtli	Apoconalnacochtli
teujlonacoch¶ tli	teujlonacochtli
itznacoch¶ tli	itznacochtli
momama¶ ujzmati	momamaujzmati
maujz¶ tic	maujztic
mo¶ iolitlacoanj	moiolitlacoanj
qujchioaz¶ que	qujchioazque
injn neiehecoliz	in·jnneiehecoliz
injn tlatocaio	in·jntlatocaio
inte qujuh	intequjuh
caquez¶ quitoton	ca·quezquitoton
inimac¶ pa	in·imacpa
inixpanpa	in·ixpanpa
in¶ in	inin
inoquiz qujntin	in·oquizqujntin
invitz¶ tlanpa	in·vitztlanpa
ini¶ matitlanpa	in·imatitlanpa
inie	in·ie
inoqujnmjcti	in·oqujnmjcti
inoyiel¶ lelquiz	in·oyiellelquiz
injntlatquj	in·jntlatquj
injnne¶ chichioal	in·jnnechichioal
inanecuiotl	in·anecuiotl
qujmotlatqui¶ ti	qujmotlatquiti
cavmpa	ca·vmpa
qujti¶ tlanja	qujtitlanja
injcoac	in·jcoac
ovm¶ poliuh	ovmpoliuh
injpan	in·jpan
inj tecutlato cahoan	in·jtecutlatocahoan
qujn¶ macaia	qujnmacaia
tlama¶ tli	tlamatli
tlaca tlatolli	tlacatlatolli
tec¶ calli	teccalli
iciuh¶ ca	iciuhca
in tlaitla	intla·itla
ie¶ hoanti	iehoanti
injntoca¶	in·jntoca
in¶ tlaaca	intla·aca
quj¶ mecanja	qujmecanja
inj temjcticaoan	in·jtemjcticaoan
ixto coaia	ixtocoaia
ioal¶ tica	ioaltica
injpa¶ pa	in·jpapa
ia uiotl	iauiotl
in tlaano	intla·ano
tetla¶ nenque	tetlanenque
in¶ ca nenonotzalo	inca·nenonotzalo
caacame	ca·acame
intetlanen¶ que	in·tetlanenque
injiaohoan	in·jiaohoan
in canenonotzaloaia	inca·nenonotzaloaia
injn pilhoan	in·jnpilhoan
in tlamacho	intla·macho
mellelqujxtia¶ ia	mellelqujxtiaia
jq¶ tiamjctia	jqtiamjctia
tla¶ cotli	tlacotli
ieix motolinja	ie·ix·motolinja
con tlalia	contlalia
quj¶ quemj	qujquemj
in tlao¶ quj tlanque	intla·oqujtlanque
njmante¶ patla	njman·tepatla
oquj¶ tlanjlique	oqujtlanjlique
ma¶ ceoalti	maceoalti
qujn maca	qujnmaca
motoli¶ njanj	motolinjanj
quj¶ tlapaloz	qujtlapaloz
cannoiuh¶	can·no·iuh
injuj¶ pil	in·jujpil
qujnpepe¶ naia	qujnpepenaia
tlato catizque	tlatocatizque
ope¶ penaloque	opepenaloque
vitzilo¶ puchtli	vitzilopuchtli
aco¶ pa	acopa
tla¶ pepenalti	tlapepenalti
vitzi¶ lopuchtli	vitzilopuchtli	
vi¶ tzilopuchtli	vitzilopuchtli	
qujnuj caia	qujnujcaia
injn¶ chan	in·jnchan
occequjntin	oc·cequjntin
na¶ ujlhujtl	naujlhujtl
oon¶ mocauh	oonmocauh
te cutlatoque	tecutlatoque
qujnj coac¶	qujnjcoac
injn chan	in·jnchan
quj pepena	qujpepena
motlato¶ capacaz	motlatocapacaz
qujn naoatia	qujnnaoatia
injxqujch¶ tin	in·jxqujchtin
quj tetlauhtiz	qujtetlauhtiz
quj temacaz	qujtemacaz
mj toa	mjtoa
quj chioaia	qujchioaia
teco¶ anotzaliztli	tecoanotzaliztli
mocenca¶ oaia	mocencaoaia
tlamanj¶ me	tlamanjme
mjiectlama¶ tli	mjiec·tlamatli
qujtlauh¶ tia	qujtlauhtia
tlaco tilmatli	tlacotilmatli
max¶ tlatl	maxtlatl
tlalpi¶ lonj	tlalpilonj
tlacama¶ chozque	tlacamachozque
qujmo cujtlaujaia	qujmocujtlaujaia
Non¶ qua	Nonqua
quj namaca	qujnamaca
xiuh tototl	xiuhtototl
tlauh quechol	tlauhquechol
inj tech	in·jtech
tlaujz¶ tli	tlaujztli
Non qua	Nonqua
mj¶ chioauhtli	mjchioauhtli
Nex¶ oauhtli	Nexoauhtli
vexo¶ lotl	vexolotl
ma¶ catl	macatl
pi¶ pixcan	pipixcan
Necutetza¶ oac	Necutetzaoac
a¶ tzitzioacaiotl	atzitzioacaiotl
tex¶ iochilli	texiochilli
injzqujtla¶ mantli	in·jzqujtlamantli
xochi qualli	xochiqualli
tianqujz¶ pan	tianqujzpan
quj¶ mocujtlauja	qujmocujtlauja
injn tequjuh	in·jntequjuh
in tequjuh	intequjuh
quj¶ tlatlauhtia	qujtlatlauhtia
qujn tlatlauhtia	qujntlatlauhtia
ienoiuhquj	ie·no·iuhquj
qujmocuj¶ tlaujtiuj	qujmocujtlaujtiuj
maca¶ na	ma·cana
qujmach¶ tia	qujmachtia
mochimaltope¶ oa	mochimaltopeoa
tla¶ malo	tlamalo
contlachi¶ eltia	contlachieltia
necujtla¶ ujlo	necujtlaujlo
camjiec	ca·mjiec
injtiacauh¶	in·jtiacauh
ietlamalo	ie·tlamalo
te¶ qujpan	tequjpan
qujo alnonotz¶ tiuetzi	qujoalnonotztiuetzi
oaci¶ co	oacico
hi¶ ciuhca	hiciuhca
mote¶ cucuma	motecucuma
o¶ anqujciauhque	oanqujciauhque
oanqujhijouj¶ que	oanqujhijoujque
ximotlali¶ can	ximotlalican
maocnjcchia	ma·oc·njcchia
quj moncaltzaqua	qujmoncaltzaqua
oqujca¶ qujtique	oqujcaqujtique
qujntla¶ tlatia	qujntlatlatia
qujn popoloa	qujnpopoloa
injneltica	in·jneltica
quj ca quja	qujcaquja
ontlama¶ que	ontlamaque
qujnqujx ti¶ aia	qujnqujxtiaia
te¶ qujpan	tequjpan
quj motehoan	qujmotehoan
mo¶ tlatlauhtia	motlatlauhtia
qujn caltzaquaia	qujncaltzaquaia
quj¶ pachozque	qujpachozque
in tlamjqujz	intla·mjqujz
ontla¶ lilo	ontlalilo
tecu¶ tlatoa	tecutlatoa
quj tzo¶ tecticate	qujtzotecticate
tlacochcal¶ catl	tlacochcalcatl
iuh qujma	iuhqujma
tla¶ mamatlatl	tlamamatlatl
injxquj¶ ch ica	in·jxqujchica
ia¶ cachto	iacachto
ocmoquateconoa	oc·moquateconoa
cuexpal¶ chicacpul	cuexpalchicacpul
tla¶ ma	tlama
intlatepal	intla·tepal
oteecaio¶ ti	oteecaioti
otemacujl caioti	otemacujlcaioti
otechi¶ quacen caioti	otechiquacencaioti
necuex¶ pallacalo	necuexpallacalo
qujmo¶ xexelhuja	qujmoxexelhuja
in mal	inmal
qui eui	quieui
toma iauh ca¶ pa	tomaiauhcapa
qui cui	quicui
toma¶ iauhcampa	tomaiauhcampa
ta cul	tacul
tenauhca¶ iotia	tenauhcaiotia
ini¶ cul	in·icul
a¶ quin	aquin
qui¶ tocaiotia	quitocaiotia
i¶ niuh	in·iuh
quin¶ icoac	quinicoac
in tlatepal	intla·tepal
mo¶ potonia	mopotonia
mocues pal¶ laca	mocuespallaca
moxi¶ ma	moxima
moqua ia oalxima	moquaiaoalxima
ini¶ coa nepantla	in·icoanepantla
mistla palhoatzal¶ huia	mistlapalhoatzalhuia
ini xaiac	in·ixaiac
qui tecozauhuia	quitecozauhuia
ini¶ calpiscahoan	in·icalpiscahoan
ini canaoacan	in·icanaoacan
inis pan	in·ispan
motecu¶ coma	motecucoma
noiuh quj¶	no·iuhquj
ini ne tlauhtil	in·inetlauhtil
ino mito	in·omito
noiuhqui	no·iuhqui
ini netlauhtil¶	in·inetlauhtil
quitiach¶ cauhtecaia	quitiachcauhtecaia
intelpochiiaqui	in·telpochiiaqui
quicala¶ quiaia	quicalaquiaia
in uehican	inuehican
tel pochcali	telpochcali
tlacaz caltia	tlacazcaltia
qui¶ mizcaltia	quimizcaltia
tel popochti	telpopochti
cuicoiano¶ oaia	cuicoianooaia
inisquich¶ ica	in·isquichica
A quj que	Aqujque
mjc ca	mjcca
ieno¶	ie·no
quj chiuh	qujchiuh
oquich¶ tli	oquichtli
ico neuh	iconeuh
I oan	Ioan
quj¶ peuh	qujpeuh
ic¶ patepec	icpatepec
cuezcoma ixtlaoacan	cuezcomaixtlaoacan
teco ma ixtlaoaca	tecomaixtlaoaca
ca ca¶ tepec	cacatepec
iollo xone¶ cuillan	iolloxonecuillan
iztectlalo can	iztec·tlalocan
chi chioaltatacalan	chichioaltatacalan
chi cuexiujtl	chicuexiujtl
io¶ altica	ioaltica
toma¶ oac	tomaoac
iuh qujn	iuhqujn
tlemjia¶ oatl	tlemjiaoatl
tona¶ tiuh	tonatiuh
iqui caiampa	iquicaiampa
oalmo quetza¶ ia	oalmoquetzaia
tona¶ tiuh	tonatiuh
nauh xiujtl	nauhxiujtl
mot¶ taia	mottaia
Españo¶ les	Españoles
ian¶ cuje	iancuje
equj njen¶ tos	e·qujnjentos
icenca	i·cenca
mj coac	mjcoac
in maic¶ onecocoloc	inm·aic·onecocoloc
mo¶ chitlacatl	mochi·tlacatl
quj tlacalhuj	qujtlacalhuj
inj xa¶ iac	in·jxaiac
quj quiztic	qujquiztic
chachaquach¶ tic	chachaquachtic
moto caia¶	motocaia
mj mjc que	mjmjcque
quj¶ montlacaia	qujmontlacaia
no¶ ujan	noujan
hijax¶ que	hijaxque
mo¶ chiuh	mochiuh
teia cacpa¶	teiacacpa
nouj¶ ian	noujian
apiz mj coac	apizmjcoac
poliuh¶ que	poliuhque
xo¶ chipilteca	xochipilteca
o¶ motlatocatlali	omotlatocatlali
tlatoca¶ iotl	tlatocaiotl
compeuh¶ que	compeuhque
me¶ xico	mexico
qujui catinen	qujuicatinen
quauhte¶ mallan	quauhtemallan
quj qua	qujqua
pil¶ tzintli	piltzintli
az¶ caputzalco	azcaputzalco
qua quauhti	quaquauhti
quauh cal¶ co	quauhcalco
tla¶ tilulco	tlatilulco
quauh¶ calco	quauhcalco
oon¶ tetl	oontetl
quj tlazque	qujtlazque
icecen¶ tetl	icecentetl
icioacoatl	i·cioacoatl
nomanca	no·manca
ve¶ xotzinco	vexotzinco
ne¶ caoalcoiotzin	necaoalcoiotzin
necaoal¶ pilli	necaoalpilli
tlato catque	tlatocatque
tza¶ cuticatca	tzacuticatca
iau¶ iutl	iauiutl
ilhuj catitech	ilhujcatitech
iuh¶ quj	iuhquj
tlemj¶ iaoatl	tlemjiaoatl
xiuh tonalli	xiuhtonalli
xiuhto¶ nalli	xiuhtonalli
nauh xiujtl¶	nauhxiujtl
intlen	in·tlen
oal¶ mo quequetzaia	oalmoquequetzaia
oalmoque¶ quetzaia	oalmoquequetzaia
injmacujlixtin	in·jmacujlixtin
quj¶ piaia	qujpiaia
inj tlatocaio	in·jtlatocaio
tequj¶ tia	tequjtia
injtlatocaio	in·jtlatocaio
vm¶ poal xiujtl	vmpoalxiujtl
mote cutla¶ li	motecutlali
mo cem¶ poa	mocempoa
centzon xiujtl	centzonxiujtl
tle cue callotl	tlecuecallotl
tlaujz calli¶	tlaujzcalli
iuh¶ qujnilhujcatl	iuhqujn·ilhujcatl
quj coticac	qujcoticac
tzimpa¶ tlaoac	tzimpatlaoac
inepan¶ tla	inepantla
injlhuj catl	in·jlhujcatl
aci¶ ticac	aciticac
ilhuj catl	ilhujcatl
ilhuj ca iollo titech¶	ilhujcaiollotitech
aci ticac	aciticac
tlap¶ copa	tlapcopa
tlathujlia¶ ia	tlathujliaia
qujtleca¶ uj	qujtlecauj
inj cal	in·jcal
dia¶ blo	diablo
ito caio çan	itocaioçan
tle¶ mj iaoatl	tlemjiaoatl
intlenenepilli	in·tlenenepilli
tlecue¶ callutl	tlecuecallutl
inixqujch	in·ixqujch
iehecatl	i·ehecatl
quj poconalti	qujpoconalti
xixite¶ mumoloca	xixitemumoloca
ma¶ coquetz	macoquetz
chiquacen tlamantli	chiquacentlamantli
cho¶ catiuh	chocatiuh
tza¶ tzi	tzatzi
quj totinemj	qujtotinemj
ieic	ie·ic
quen manja	quenmanja
quj¶ toa	qujtoa
na¶ mech nouj qujliz	namechnoujqujliz
quj motetzauj¶	qujmotetzauj
quj mjttac	qujmjttac
on¶ tlachix	ontlachix
injc pac	in·jcpac
quj¶ ttac	qujttac
mo¶ quequetztitiujtze	moquequetztitiujtze
qujn ma¶ ma	qujnmama
qujn¶ notz	qujnnotz
tlamatinj¶ me	tlamatinjme
quj mj lhuj	qujmjlhuj
inj coppa	injc·oppa
maacame	ma·acame
chi cuetetl	chicuetetl
mjiec¶ pa	mjiecpa
tlacane¶ tzolti	tlacanetzolti
cace	ca·ce
injn¶ tlac	in·jntlac
quj monuj caia	qujmonujcaia
quj mj ttaia	qujmjttaia
po¶ liujia	poliujia
I njpan	In·jpan
quj caco	qujcaco
iau qujzque	iauqujzque
quj ma	qujma
motecucu¶ ma	motecucuma
tlaihoa iaque	tlaihoaiaque
inj¶ titlanhoan	in·jtitlanhoan
quj¶ iaunamj quj to	qujiaunamjqujto
imo¶ tonhoan	imotonhoan
oqujmjcal¶ que	oqujmjcalque
tlax callan	tlaxcallan
mjc que¶	mjcque
imoton hoan	imotonhoan
qujn¶ mjctique	qujnmjctique
qujn ma cato	qujnmacato
qujn huj caque	qujnhujcaque
qujnpacca tlapaloto	qujnpaccatlapaloto
in¶ chan	inchan
quj nonotz¶ que	qujnonotzque
inj tlatol	in·jtlatol
inj ta¶	in·jta
mote cucuma	motecucuma
quj macaque	qujmacaque
injntetlapaloaia	in·jntetlapaloaia
inj¶ quezqujlhujioc	in·jquezqujlhujioc
inj¶ coac	in·jcoac
aten¶ co	atenco
occentlamantin	oc·centlamantin
oqujn¶ na mj qujto	oqujnnamjqujto
quj cauhtia	qujcauhtia
inj¶tlan	in·jtlan
mjie qujntin	mjiequjntin
qujn mjc¶ tique	qujnmjctique
inqujlhujqujx¶ tiliaia	in·qujlhujqujxtiliaia
tla¶ toque	tlatoque
chicu nauj	chicunauj
tenjx¶ io	tenjxio
te¶ malacaio	temalacaio
itzcoa¶ io	itzcoaio
vmetochte¶ comaio	vmetochtecomaio
papalo¶ io	papaloio
xaoalquauh¶ io	xaoalquauhio
ocelotentla¶ palli	ocelotentlapalli
tlacoch¶ quauhtli	tlacochquauhtli
quetzalich¶ tilmatli	quetzalichtilmatli
ocelo·cujtlapillo	ocelocujtlapillo
quetza¶ lichpetztli	quetzalichpetztli
camopal·ecacoz·caio	camopalecacozcaio
til¶ matli	tilmatli
i¶ uj tica	iujtica
nochpaltil¶ matli	nochpaltilmatli
quappachtentla¶ iaoalo	quappachtentlaiaoalo
coioichcatentla¶ iaoalo	coioichcatentlaiaoalo
quappachtlal¶ pilli	quappachtlalpilli
ocelotil¶ matli	ocelotilmatli
oce¶ lotilmatli	ocelotilmatli
ocelo quauhtlatlapan¶ quj	oceloquauhtlatlapanquj
quappachixcoliuh¶ quj	quappachixcoliuhquj
tilma¶ tli	tilmatli
xo¶ moiuj tilmatli	xomoiujtilmatli
xomo¶ iujtilmatli	xomoiujtilmatli
xo¶ moiujtilmatli	xomoiujtilmatli
xomo iuj¶ tilmatli	xomoiujtilmatli
cuj tlaichuj tilmatli	cujtlaichujtilmatli
xiuh tlalpilli	xiuhtlalpilli
tonatiuh io¶	tonatiuhio
tlachi¶ nol	tlachinol
tlapaltecuxu¶ chio	tlapaltecuxuchio
acucu xuchio	acucuxuchio
cuetlaxxu¶ chio	cuetlaxxuchio
xomo iuj tilma¶ tli	xomoiujtilmatli
nacaz mjnquj	nacazmjnquj
xomo iuj¶ tilmatli	xomoiujtilmatli
cuj tlachixio	cujtlachixio
quauh a auj tzoio	quauhaaujtzoio
te¶ njz quj xuchio	tenjzqujxuchio
qua xoxo¶ tilmatli	quaxoxotilmatli
ne¶ oatzalonj	neoatzalonj
qua xoxoacatlamachio¶	quaxoxoacatlamachio
quauh tetepoio	quauhtetepoio
xiuh tez¶ caio	xiuhtezcaio
max¶ tlatl	maxtlatl
centzon ma xtlatl	centzonmaxtlatl
tlatlatla¶ palpoalli	tlatlatlapalpoalli
aca heca¶ cozcaio	acahecacozcaio
quap pach maxtlatl	quappachmaxtlatl
oce¶ lotzonte io io	ocelotzonteioio
ocelo xical coliuh quj¶	oceloxicalcoliuhquj
aca¶ iujtemalacaio	acaiujtemalacaio
acatla¶ machmoiaoac	acatlamachmoiaoac
quj¶ namjqujto	qujnamjqujto
her¶ nando	hernando
quj cac	qujcac
ynjx qujchtin	yn·jxqujchtin
mo¶ mauhtique	momauhtique
occeppa	oc·ceppa
quj mjhoa	qujmjhoa
qujt¶ quj que	qujtqujque
injxiuhtzin	in·jxiuhtzin
oalmo¶ iauchichiuhtia	oalmoiauchichiuhtia
quj namjqujto	qujnamjqujto
cal¶ tenco	caltenco
quj¶ paccananjqujto	qujpaccananjqujto
quj tlatlauh¶ ti	qujtlatlauhti
quj tlapalo	qujtlapalo
injxqujchtin	in·jxqujchtin
ocelo cujtlapillo	ocelocujtlapillo
camopal ecacoz caio	camopalecacozcaio
teocuj¶ tlaio	teocujtlaio
intzonque¶ tzalpatzactli	intzon·quetzalpatzactli
teo cujtlaio¶	teocujtlaio
quj mama	qujmama
tlauh quetzoltzontlj¶	tlauhquetzoltzontlj
icue cuetla¶ cacaio	icuecuetlacacaio
iuj cal	iujcal
teo cuj¶ tlaio	teocujtlaio
mj¶ totia	mjtotia
teo cuj tlanacochtli	teocujtlanacochtli
chal¶ chiujtl	chalchiujtl
ololiuh quj	ololiuhquj
teu¶ xiujtl	teuxiujtl
inj maquechtlan	in·jmaquechtlan
quj tlalia	qujtlalia
tla¶ chiuhtli	tlachiuhtli
chalchiuh¶ tentetl	chalchiuhtentetl
teu cuj tlatica	teucujtlatica
tlamjn¶ tli	tlamjntli
injntenco	in·jntenco
teu cujtlatl	teucujtlatl
inj callo	in·jcallo
inj maquechtlan¶	in·jmaquechtlan
teucuj tla¶ tica	teucujtlatica
chalchiuh tecaca¶ necujlli	chalchiuhtecacanecujlli
tlatzin¶ callotilli	tlatzincallotilli
teu cuj tla tempilolli	teucujtlatempilolli
atoto tempilolli	atototempilolli
teu cuj¶ tlatl	teucujtlatl
xiuh coatempilolli	xiuhcoatempilolli
aujc tempilolli	aujctempilolli
temalaca tentetl	temalacatentetl
teu¶ xiujtl	teuxiujtl
chalchiuh tencololli	chalchiuhtencololli
inixqujch¶	in·ixqujch
chal chiuh quauh ten¶ tetl	chalchiuhquauhtentetl
apatlac tempilolli	apatlactempilolli
teucuj¶ tlatl	teucujtlatl
teu xiuh¶ iaca mjtl	teuxiuhiacamjtl
chalchiuh coz catl	chalchiuhcozcatl
olo¶ liuh quj	ololiuhquj
teu cuj tlachaiaoac	teucujtlachaiaoac
chalchiuh tlacama oalli	chalchiuhtlacamaoalli
quetzal machoncotl	quetzalmachoncotl
metz tempilolli	metztempilolli
tlacoinj tica	tlacoinjtica
teu cujtlaio	teucujtlaio
teu cujtlacotzeoatl	teucujtlacotzeoatl
quetzal macpanjtl	quetzalmacpanjtl
quetzaltoto ic¶ pacxuchitl	quetzaltotoicpacxuchitl
quetzal qua quaujtl	quetzalquaquaujtl
teucujtla¶ io	teucujtlaio
xiuh macopilli	xiuhmacopilli
teucujtla¶ chipulcozcatl	teucujtlachipulcozcatl
teu cujtla coztic	teucujtlacoztic
acuech¶ cozcatl	acuechcozcatl
tla¶ toanj	tlatoanj
o¶ celoeoacactli	oceloeoacactli
tlama¶ chio	tlamachio
tlamach cactli	tlamachcactli
te¶ ponaz tzatzaztli	teponaztzatzaztli
cuj canjme	cujcanjme
tlatzo¶ tzonquj	tlatzotzonquj
cuj caito anj	cujcaitoanj
tlaujz petla¶ calli	tlaujzpetlacalli
teu¶ cujtlanacochtli	teucujtlanacochtli
teu cuj tlacoz catl	teucujtlacozcatl
teu cujtla aca¶ coatl	teucujtlaacacoatl
xuchi qua¶ ujtl	xuchiquaujtl
tezca tanatli	tezcatanatli
tziquaoaztana¶ tli	tziquaoaztanatli
tepo¶ naztli	teponaztli
meellel qujxtiaia	meellelqujxtiaia
I njcoac	In·jcoac
matlato tiuh	matlatotiuh
injte¶ chiuh caoan	in·jtechiuhcaoan
quece¶ oatl	queceoatl
inj taoan	in·jtaoan
quj tlapeujlitiuj	qujtlapeujlitiuj
qujia caujltequj	qujiacaujltequj
mocuj ca¶ machtia	mocujcamachtia
cuj caeheooa	cujcaeheooa
quj tlatlaque¶ chilia	qujtlatlaquechilia
quj cacanjlhuja	qujcacanjlhuja
vn¶ catca	vncatca
imolpix caoa	imolpixcaoa
inmolan¶ caoan	inmolancaoan
quj tlanjtoa	qujtlanjtoa
tlaco¶ tli	tlacotli
inteo cujtlacozcatl	in·teocujtlacozcatl
tlacomax¶ tlatl	tlacomaxtlatl
te¶ ucujtlamatemecatl	teucujtlamatemecatl
quetzalmachon¶ cotl	quetzalmachoncotl
xomo iuj tilmatli	xomoiujtilmatli
cacaoape¶ tlatl	cacaoapetlatl
tlach¶ tli	tlachtli
ono¶ ca	onoca
tlachte¶ malacatl	tlachtemalacatl
ollama¶ nj	ollamanj
quj ca¶ laquja	quicalaquja
quj tlanj	qujtlanj
inj x¶ qujch	in·jxqujch
muchin¶ tin	muchintin
quj ntlanj	qujntlanj
injxqujchtin	in·jxqujchtin
tetlatla¶ ttaque	tetlatlattaque
itlauj callo	itlaujcallo
aie cotli	aiecotli
tlaix coionjlli	tlaixcoionjlli
quj chaia¶ oa	qujchaiaoa
quj cujloa	qujcujloa
mj cujloa	mjcujloa
tlapoal¶ tetl	tlapoaltetl
chichi¶ quacentetl	chichiquacentetl
in tlapoal¶ teuh	intlapoalteuh
ice cemme	icecemme
inj xnamjquj¶	in·jxnamjquj
quj tlanjlia¶	qujtlanjlia
teucuj¶ tlacoz catl	teucujtlacozcatl
olo liuhquj	ololiuhquj
tlaco¶ tilmatli	tlacotilmatli
teu cujtla¶ nacochtli	teucujtlanacochtli
xomo iuj tilmatli	xomoiujtilmatli
pato anj	patoanj
quj chaiaoa¶	qujchaiaoa
tee quechi¶ li	teequechili
tzin mj mj ltic	tzinmjmjltic
tetzammacho¶ ia	tetzammachoia
tlamauj colli	tlamaujcolli
mo¶ ttaia	mottaia
inj x¶ quj ch	in·jxqujch
ma¶ canel	macanel
quez quj tetl¶	quezqujtetl
Oceloeoatepotzo icpalli	Oceloeoatepotzoicpalli
mj¶ ceoa tepotzo icpalli	mjceoatepotzoicpalli
cuj tlacheoa¶ tepotzo icpalli	cujtlacheoatepotzoicpalli
ocoto cheoa tepo¶ tzo icpalli	ocotocheoatepotzoicpalli
cuetlaxtepotzo icpalli	cuetlaxtepotzoicpalli
oceloeoa icpalli	oceloeoaicpalli
mjceoa icpalli	mjceoaicpalli
cuj tlach eoa icpalli	cujtlacheoaicpalli
cuetlax ic¶ palli	cuetlaxicpalli
ocoto cheoa ic palli	ocotocheoaicpalli
coio eoa¶ icpalli	coioeoaicpalli
oceloeoa pepechtli	oceloeoapepechtli
mj ceoa¶ pepechtli	mjceoapepechtli
ocotocheoa pepechtli	ocotocheoapepechtli
co¶ ioeoa pepechtli	coioeoapepechtli
cochiz matlatl	cochizmatlatl
ala¶ oacapetlatl	alaoacapetlatl
tepotzo¶ icpalli	tepotzoicpalli
tla¶ cujlolli	tlacujlolli
inquj titlanja	in·qujtitlanja
Tlauh quecholtzontli	Tlauhquecholtzontli
tlacotlan¶ quj	tlacotlanquj
teu cuj tlaio	teucujtlaio
icuecue tlacacaio	icuecuetlacacaio
tla¶ chiuhtli	tlachiuhtli
inj tetecpaio	in·jtetecpaio
inj tzapocue	in·jtzapocue
tlaco iujtl	tlacoiujtl
inj tentlapilollo	in·jtentlapilollo
muchi¶ uhtoc	muchiuhtoc
chalchiuh cozcatl	chalchiuhcozcatl
tlacen¶ qujxtilli	tlacenqujxtilli
chal chiujtl	chalchiujtl
teu xiujtl	teuxiujtl
xiuh¶ tototzontli	xiuhtototzontli
inj cue cue tlacacaio	in·jcuecuetlacacaio
inj tzonte¶ con	in·jtzontecon
con maquja	conmaquja
inj¶ tlac	in·jtlac
cona quja	conaquja
ve¶ uetl	veuetl
teu¶ cuj tlaio	teucujtlaio
inj¶ tzapocue	in·jtzapocue
tlaco iujtl	tlacoiujtl
inj¶ tlapilollo	in·jtlapilollo
inj tetecpaio	in·jtetecpaio
xiuh¶ totoeoatl	xiuhtotoeoatl
ocelo totec	ocelototec
teu cuj tlatl¶	teucujtlatl
inj tetecpaio	in·jtetecpaio
inj tzapocue	in·jtzapocue
oce¶ loueuetl	oceloueuetl
teu¶ cuj tlatl	teucujtlatl
tlotlouj tequj	tlotloujtequj
iquetzal quaquauh	iquetzalquaquauh
quetzal¶ patzactli	quetzalpatzactli
xiuh totoeoatl	xiuhtotoeoatl
toz¶ qua xolotl	tozquaxolotl
xoxouh quj	xoxouhquj
motlotlo¶ ujtec	motlotloujtec
cuex tecatl	cuextecatl
ico¶ pil	icopil
ujtzauh quj	ujtzauhquj	
ixquateucuj¶ tlaio	ixquateucujtlaio	
injiaca metz	in·jiacametz
i¶ pipilol	ipipilol
imama¶ lacaquetzal	imamalacaquetzal
Chic¶ tlapanquj	Chictlapanquj
chic¶ tlapanquj	chictlapanquj
cuj¶ tlalpic	cujtlalpic
ixquateu cujtlaio	ixquateucujtlaio
teucuj tlatl	teucujtlatl
inj ia cametz	in·jiacametz
imamalacaque¶ tzal	imamalacaquetzal
teucujtlaco¶ pilli	teucujtlacopilli
quj qujztli	qujqujztli
mo¶ pitza	mopitza
iau qujz¶ que	iauqujzque
que¶ tzalpanjtl	quetzalpanjtl
inteeujtia	in·teeujtia
injzquj¶	in·jzquj
inj tenco¶	in·jtenco
teu¶ cujtlaio	teucujtlaio
quetzal xixilquj	quetzalxixilquj
inj cue cuetla cacaio	in·jcuecuetlacacaio
injpo conca	in·jpoconca
que¶ tzalxixilquj	quetzalxixilquj
inj cuecuetla¶ cacaio	in·jcuecuetlacacaio
inj tlaqual	in·jtlaqual
injztac	in·jztac
tla¶ qualli	tlaqualli
tlaxcalmj mjlli	tlaxcalmjmjlli
inj mollo	in·jmollo
inj¶ vical	in·jvical
to¶ potli	topotli
injx¶ qujch	in·jxqujch
tla¶ qua	tlaqua
tlato catitlanti	tlatocatitlanti
moiautitla¶ que	moiautitlaque
tecutla¶ toque	tecutlatoque
ach cacauhti	achcacauhti
tel¶ puchtlatoque	telpuchtlatoque
tla¶ macazque	tlamacazque
quez¶ quj	quezquj
iiahach¶ hoan	iiahachhoan
teu cujtlapitz¶ que	teucujtlapitzque
chal¶ chiuhtlacujloque	chalchiuhtlacujloque
teu¶ xinque	teuxinque
inj¶ calitic	in·jcalitic
ie cauj	iecauj
inj cacaoauh	in·jcacaoauh
xo¶ xouhquj	xoxouhquj
caca oacintli	cacaoacintli
quauh¶ necujo	quauhnecujo
xochio cacaoatl	xochiocacaoatl
xochi¶ palcacaoatl	xochipalcacaoatl
tlacuj¶ lolli	tlacujlolli
atzac¶ caiotl	atzaccaiotl
aio tectli	aiotectli
oceloe¶ oatl	oceloeoatl
cuetlax aiaoalli	cuetlaxaiaoalli
atzetzel¶ oaztli	atzetzeloaztli
ve¶ vei	vevei
tla¶ cujlolxicalli	tlacujlolxicalli
tlaqual¶ chiqujujtl	tlaqualchiqujujtl
injx qujch¶	in·jxqujch
inj neteilhujl	in·jneteilhujl
cujtla pilli¶	cujtlapilli
qujca¶ qujliaia	qujcaqujliaia
qujtlatzontequj¶ liaia	qujtlatzontequjliaia
mj¶ qujztli	mjqujztli
quj mecanjzque	qujmecanjzque
quauh¶ tica	quauhtica
ma¶ ceoalcuepaloz	maceoalcuepaloz
quauh calco	quauhcalco
qujntlatla collacaia	qujntlatlacollacaia
mjicqujn¶ tin	mjicqujntin
injntel¶ puchoan	in·jntelpuchoan
inj mjchpuchoan	in·jmjchpuchoan
tla¶ naoati	tlanaoati
inj xqujch¶ tin	in·jxqujchtin
injntecujiohoan	in·jntecujiohoan
injntlatquj	in·jntlatquj
tla¶ cuelpacholli	tlacuelpacholli
quauh¶ tlaqualli	quauhtlaqualli
patz¶ callo	patzcallo
tonal¶ chillo	tonalchillo
tlaman¶ tli	tlamantli
mexix¶ qujlitl	mexixqujlitl
momuz¶ tlae	momuztlae
cujtla¶ pilli	cujtlapilli
io¶ cuxca	iocuxca
injn neteilhujl¶	in·jnneteilhujl
quj¶ poaia	qujpoaia
qujn neltiliaia	qujnneltiliaia
qujn temoaia	qujntemoaia
tla¶ neltilianj	tlaneltilianj
quj machilia	qujmachilia
moteil¶ hujque	moteilhujque
intlaitla	intla·itla
qujn machili¶	qujnmachili
injneteilhujl¶	in·jneteilhujl
hoa¶ iolcaiotl	hoaiolcaiotl
te¶ cutlatoque	tecutlatoque
qujn¶ mjcti	qujnmjcti
motecu¶ cuma	motecucuma
qujn ma¶ chili	qujnmachili
mjxcoa tlailotlac¶	mjxcoatlailotlac
teic notlamachti	teicnotlamachti
iz¶ tlaca	iztlaca
to¶ qual	toqual
injntequjuh¶	in·jntequjuh
qujn¶ mjcti	qujnmjcti
qujtlatzon¶ tequjlia	qujtlatzontequjlia
tetepacho¶ lo	tetepacholo
tlato¶ cati	tlatocati
vitz¶ naoatl	vitznaoatl
ocon¶ teixupauique	oconteixupauique
tlacoch calcatl¶	tlacochcalcatl
injn neixcaujl	in·jnneixcaujl
Ach cauh calli	Achcauhcalli
achca¶ cauhti	achcacauhti
inj temjcticaoan¶	in·jtemjcticaoan
quj tzon¶ qujxtiaia	qujtzonqujxtiaia
omo¶ tzontec	omotzontec
quauh nochtli	quauhnochtli
atempane¶ catl	atempanecatl
qujtla¶ coaia	qujtlacoaia
quj tzacutiuja	qujtzacutiuja
injtla	in·jtla
Cuj¶ cacalli	Cujcacalli
tlatecpa¶ noaia	tlatecpanoaia
oncujcoanooa¶ ia	oncujcoanooaia
çan ijo	çanijo
inonactiuja	inonactiuja
imaz¶ taxel	imaztaxel
intel puchtli	in·telpuchtli
inon¶ cujco anoia	in·oncujcoanoia
cala¶ quja	calaquja
amoac	amoac
inonactiuja	in·onactiuja
in tzonchichilicpatl	intzonchichilicpatl
quj qujxtia	qujqujxtia
quj¶ tetequjtia	qujtetequjtia
qujte¶ tequjtia	qujtetequjtia
qujntlatzonte¶ qujlia	qujntlatzontequjlia
qujn¶ mecanja	qujnmecanja
maujz¶ tli	maujztli
mopia¶ ia	mopiaia
ma¶ cujltzontli	macujltzontli
cempoal¶ xiuhcaiotl	cempoalxiuhcaiotl
injtetzon	in·jtetzon
quauh cuezcontica	quauhcuezcontica
chian tzo¶ tzol	chiantzotzol
chilpe¶ tlatl	chilpetlatl
quauh aio¶ oachtli	quauhaiooachtli
tla¶ tlacoanj	tlatlacoanj
quj cencauhti¶	qujcencauhti
in piel	inpiel
quj macaia	qujmacaia
qujma¶ chili	qujmachili
qujna¶ oalchioa	qujnaoalchioa
injpiel	in·jpiel
aca¶ como	acacomo
inj¶ piel	in·jpiel
inj cioahoan	in·jcioahoan
inj cal¶	in·jcal
injtlat¶ quj	in·jtlatquj
mochitech	moch·itech
chal¶ chiuh macuextli	chalchiuhmacuextli
injicnjhoan	in·jicnjhoan
intla¶ co maxtlatl	in·tlacomaxtlatl
inteucujtlatentetl	in·teucujtlatentetl
chalchiuh ten¶ tetl	chalchiuhtentetl
chalchiuh cozcatl	chalchiuhcozcatl
tecpa¶ noaia	tecpanoaia
macohoalcujca¶ njme	macohoalcujcanjme
quj¶ iehecoz	qujiehecoz
acoitla	aco·itla
cuj catl¶	cujcatl
quj momachtiz	qujmomachtiz
mocencauh¶ ticatca	mocencauhticatca
aia cachtli	aiacachtli
coco¶ loctli	cocoloctli
cuj caitoanj	cujcaitoanj
macehoallat¶ qujtl	macehoallatqujtl
in tlauexotzincaiotl	intla·uexotzincaiotl
iniuh	in·iuh
vexo¶ tzinca	vexotzinca
motla¶ iehhecalhuja	motlaiehhecalhuja
inj ca	in·jca
qujn caquj¶ tia	qujncaqujtia
Injx¶ qujchtin	In·jxqujchtin
inj¶ tlan	in·jtlan
teicnelia¶ nj	teicnelianj
quj¶ naoatia	qujnaoatia
ouelquj¶ tlapalo	ouelqujtlapalo
injn¶ tlatol	in·jntlatol
qujn¶ tlaiehecalhuja	qujntlaiehecalhuja
quacoz¶ tique	quacoztique
quapa¶ tlachtic	quapatlachtic
caxtolxiuh¶ tia	caxtolxiuhtia
quj¶ ca	qujca
qujntlaqual¶ tia	qujntlaqualtia
quj matlitia	qujmatlitia
qujntlauh¶ tia	qujntlauhtia
nochpal maxtlatl	nochpalmaxtlatl
qujtzacu¶ tiuh	qujtzacutiuh
quj tlacoa	qujtlacoa
cuj¶ canjme	cujcanjme
quj cha¶ lanja	qujchalanja
cuj¶ caitoa	cujcaitoa
quj poloa	qujpoloa
netoti¶ liztli	netotiliztli
tla¶ toanj	tlatoanj

